us_state,year_of_record,species_name,adult_count,youth_count,unknown_count,euthanasia_sum
AK,2013,Cats,0,0,0,0
AK,2013,Dogs,0,0,0,0
AK,2014,Cats,0,0,0,0
AK,2014,Dogs,0,0,0,0
AK,2015,Cats,0,0,0,0
AK,2015,Dogs,0,0,0,0
AK,2016,Cats,29,5,0,34
AK,2016,Dogs,16,0,0,16
AK,2017,Cats,41,5,1,47
AK,2017,Dogs,18,1,0,19
AK,2018,Cats,35,1,0,36
AK,2018,Dogs,34,0,0,34
AK,2019,Cats,29,1,0,30
AK,2019,Dogs,11,0,0,11
AK,2020,Cats,10,3,0,13
AK,2020,Dogs,4,1,0,5
AK,2021,Cats,125,11,0,136
AK,2021,Dogs,29,6,0,35
AK,2022,Cats,0,1,0,1
AK,2022,Dogs,0,0,0,0
AL,2013,Cats,4,0,0,4
AL,2013,Dogs,0,0,0,0
AL,2014,Cats,465,1012,0,1477
AL,2014,Dogs,608,587,0,1195
AL,2015,Cats,503,814,4930,6247
AL,2015,Dogs,661,506,6305,7472
AL,2016,Cats,849,1599,4859,7307
AL,2016,Dogs,948,732,5112,6792
AL,2017,Cats,1316,1939,3866,7121
AL,2017,Dogs,1735,1005,3656,6396
AL,2018,Birds,0,2,0,2
AL,2018,Cats,2273,3671,350,6294
AL,2018,Dogs,4883,1588,341,6812
AL,2018,Equine,0,0,0,0
AL,2018,Farm Animals,0,0,0,0
AL,2018,Rabbits,0,0,0,0
AL,2018,Reptiles & Amphibians,0,0,0,0
AL,2018,Small Mammals,0,10,0,10
AL,2019,Birds,1,6,0,7
AL,2019,Cats,1213,2106,109,3428
AL,2019,Dogs,3650,928,211,4789
AL,2019,Equine,0,0,0,0
AL,2019,Farm Animals,0,0,0,0
AL,2019,Rabbits,0,1,0,1
AL,2019,Reptiles & Amphibians,0,1,0,1
AL,2019,Small Mammals,3,21,0,24
AL,2020,Birds,0,3,0,3
AL,2020,Cats,2155,1161,168,3484
AL,2020,Dogs,4128,696,149,4973
AL,2020,Equine,0,0,0,0
AL,2020,Farm Animals,0,0,0,0
AL,2020,Rabbits,0,1,0,1
AL,2020,Reptiles & Amphibians,0,1,0,1
AL,2020,Small Mammals,5,11,0,16
AL,2021,Birds,0,6,0,6
AL,2021,Cats,1347,1275,530,3152
AL,2021,Dogs,4547,554,603,5704
AL,2021,Equine,1,0,0,1
AL,2021,Farm Animals,0,0,0,0
AL,2021,Rabbits,0,0,0,0
AL,2021,Reptiles & Amphibians,0,0,0,0
AL,2021,Small Mammals,2,9,0,11
AL,2022,Birds,0,0,0,0
AL,2022,Cats,88,14,60,162
AL,2022,Dogs,809,164,196,1169
AL,2022,Equine,0,0,0,0
AL,2022,Farm Animals,0,0,0,0
AL,2022,Rabbits,1,0,0,1
AL,2022,Reptiles & Amphibians,0,0,0,0
AL,2022,Small Mammals,1,0,0,1
AR,2013,Cats,0,0,11,11
AR,2013,Dogs,0,3,2,5
AR,2014,Cats,15,1,8,24
AR,2014,Dogs,13,0,7,20
AR,2015,Birds,0,0,0,0
AR,2015,Cats,83,54,3,140
AR,2015,Dogs,59,21,4,84
AR,2015,Equine,0,0,0,0
AR,2015,Farm Animals,0,0,0,0
AR,2015,Rabbits,0,0,0,0
AR,2015,Reptiles & Amphibians,0,0,0,0
AR,2015,Small Mammals,0,0,0,0
AR,2016,Cats,867,297,8,1172
AR,2016,Dogs,1367,406,25,1798
AR,2017,Cats,371,166,2,539
AR,2017,Dogs,411,34,7,452
AR,2018,Cats,398,140,69,607
AR,2018,Dogs,663,133,151,947
AR,2019,Cats,411,300,85,796
AR,2019,Dogs,940,128,218,1286
AR,2020,Birds,0,0,0,0
AR,2020,Cats,255,162,28,445
AR,2020,Dogs,557,72,54,683
AR,2020,Equine,0,0,0,0
AR,2020,Farm Animals,0,0,0,0
AR,2020,Rabbits,0,0,0,0
AR,2020,Reptiles & Amphibians,0,0,0,0
AR,2020,Small Mammals,0,0,0,0
AR,2021,Birds,0,0,0,0
AR,2021,Cats,186,99,0,285
AR,2021,Dogs,297,50,0,347
AR,2021,Equine,0,0,0,0
AR,2021,Farm Animals,1,0,0,1
AR,2021,Rabbits,1,0,0,1
AR,2021,Reptiles & Amphibians,0,0,0,0
AR,2021,Small Mammals,10,0,0,10
AR,2022,Birds,0,0,0,0
AR,2022,Cats,14,3,0,17
AR,2022,Dogs,41,4,0,45
AR,2022,Equine,0,0,0,0
AR,2022,Farm Animals,0,0,0,0
AR,2022,Rabbits,0,0,0,0
AR,2022,Reptiles & Amphibians,0,0,0,0
AR,2022,Small Mammals,0,0,1,1
AZ,2001,Cats,0,0,0,0
AZ,2001,Dogs,0,0,0,0
AZ,2011,Cats,1,2,0,3
AZ,2011,Dogs,4,0,0,4
AZ,2012,Cats,0,0,0,0
AZ,2012,Dogs,9,1,0,10
AZ,2013,Cats,47,10,5,62
AZ,2013,Dogs,54,4,5,63
AZ,2014,Cats,35,12,12,59
AZ,2014,Dogs,72,6,8,86
AZ,2015,Cats,1462,508,106,2076
AZ,2015,Dogs,6526,249,78,6853
AZ,2016,Cats,2097,1129,2107,5333
AZ,2016,Dogs,5984,452,521,6957
AZ,2017,Cats,1947,1286,2515,5748
AZ,2017,Dogs,3342,514,450,4306
AZ,2018,Cats,1678,1163,1323,4164
AZ,2018,Dogs,2852,509,397,3758
AZ,2019,Cats,2004,2217,975,5196
AZ,2019,Dogs,2831,365,376,3572
AZ,2020,Birds,0,0,0,0
AZ,2020,Cats,1758,1432,751,3941
AZ,2020,Dogs,1830,168,191,2189
AZ,2020,Equine,0,0,0,0
AZ,2020,Farm Animals,0,0,0,0
AZ,2020,Rabbits,0,0,0,0
AZ,2020,Reptiles & Amphibians,0,0,0,0
AZ,2020,Small Mammals,0,0,0,0
AZ,2021,Birds,2,0,4,6
AZ,2021,Cats,1798,1387,575,3760
AZ,2021,Dogs,1828,349,172,2349
AZ,2021,Equine,0,0,0,0
AZ,2021,Farm Animals,0,0,0,0
AZ,2021,Rabbits,12,2,5,19
AZ,2021,Reptiles & Amphibians,1,0,0,1
AZ,2021,Small Mammals,9,0,2,11
AZ,2022,Birds,0,0,0,0
AZ,2022,Cats,508,135,35,678
AZ,2022,Dogs,499,80,13,592
AZ,2022,Equine,0,0,0,0
AZ,2022,Farm Animals,0,0,0,0
AZ,2022,Rabbits,9,0,3,12
AZ,2022,Reptiles & Amphibians,1,0,0,1
AZ,2022,Small Mammals,0,0,0,0
CA,1993,Cats,0,0,0,0
CA,1993,Dogs,0,0,0,0
CA,1994,Cats,0,0,0,0
CA,1994,Dogs,0,0,0,0
CA,1995,Cats,0,0,0,0
CA,1995,Dogs,0,0,0,0
CA,1996,Cats,0,0,0,0
CA,1996,Dogs,0,0,0,0
CA,1997,Cats,0,0,0,0
CA,1997,Dogs,0,0,0,0
CA,1998,Cats,0,0,0,0
CA,1998,Dogs,0,0,0,0
CA,1999,Cats,0,0,0,0
CA,1999,Dogs,0,0,0,0
CA,2000,Cats,0,0,0,0
CA,2000,Dogs,0,0,0,0
CA,2001,Cats,0,0,0,0
CA,2001,Dogs,0,0,0,0
CA,2002,Cats,0,0,0,0
CA,2002,Dogs,0,0,0,0
CA,2003,Cats,0,0,0,0
CA,2003,Dogs,0,0,0,0
CA,2004,Cats,0,0,0,0
CA,2004,Dogs,0,0,0,0
CA,2005,Cats,0,0,0,0
CA,2005,Dogs,0,0,0,0
CA,2006,Cats,0,0,0,0
CA,2006,Dogs,0,0,0,0
CA,2007,Cats,0,0,0,0
CA,2007,Dogs,0,0,0,0
CA,2008,Cats,0,0,0,0
CA,2008,Dogs,0,0,0,0
CA,2009,Cats,0,0,0,0
CA,2009,Dogs,0,0,0,0
CA,2010,Cats,0,0,0,0
CA,2010,Dogs,0,0,0,0
CA,2011,Cats,4950,5064,2983,12997
CA,2011,Dogs,10973,3033,945,14951
CA,2012,Cats,3867,3680,3796,11343
CA,2012,Dogs,10475,3123,1469,15067
CA,2013,Cats,2696,2546,4603,9845
CA,2013,Dogs,9038,2687,1915,13640
CA,2014,Cats,2590,2564,3955,9109
CA,2014,Dogs,7604,1915,2667,12186
CA,2015,Cats,3064,4560,4862,12486
CA,2015,Dogs,7362,1337,2413,11112
CA,2015,Equine,0,0,0,0
CA,2015,Farm Animals,3,0,0,3
CA,2016,Cats,18980,23853,14231,57064
CA,2016,Dogs,17129,1327,5568,24024
CA,2016,Equine,1,0,0,1
CA,2016,Rabbits,0,0,1,1
CA,2017,Cats,22214,25713,8814,56741
CA,2017,Dogs,17831,1299,3844,22974
CA,2017,Farm Animals,6,0,0,6
CA,2017,Rabbits,1,0,1,2
CA,2018,Birds,0,0,22,22
CA,2018,Cats,17468,15356,7014,39838
CA,2018,Dogs,14637,990,4662,20289
CA,2018,Equine,0,0,0,0
CA,2018,Farm Animals,0,0,0,0
CA,2018,Rabbits,0,2,5,7
CA,2018,Reptiles & Amphibians,0,0,1,1
CA,2018,Small Mammals,0,0,32,32
CA,2019,Birds,0,0,11,11
CA,2019,Cats,14491,23735,24157,62383
CA,2019,Dogs,15260,1232,5620,22112
CA,2019,Equine,1,0,0,1
CA,2019,Farm Animals,0,0,0,0
CA,2019,Rabbits,0,0,14,14
CA,2019,Reptiles & Amphibians,0,0,4,4
CA,2019,Small Mammals,0,0,16,16
CA,2020,Birds,0,0,7,7
CA,2020,Cats,6954,6587,7784,21325
CA,2020,Dogs,7598,645,2274,10517
CA,2020,Equine,0,0,0,0
CA,2020,Farm Animals,0,0,0,0
CA,2020,Rabbits,1,0,2,3
CA,2020,Reptiles & Amphibians,0,0,0,0
CA,2020,Small Mammals,1,0,9,10
CA,2021,Birds,44,5,183,232
CA,2021,Cats,6892,9175,3770,19837
CA,2021,Dogs,8558,856,1312,10726
CA,2021,Equine,1,0,0,1
CA,2021,Farm Animals,11,3,30,44
CA,2021,Rabbits,20,8,23,51
CA,2021,Reptiles & Amphibians,10,1,33,44
CA,2021,Small Mammals,40,15,36,91
CA,2022,Birds,5,0,35,40
CA,2022,Cats,984,285,302,1571
CA,2022,Dogs,1719,132,255,2106
CA,2022,Equine,0,0,0,0
CA,2022,Farm Animals,2,1,8,11
CA,2022,Rabbits,5,2,12,19
CA,2022,Reptiles & Amphibians,1,0,7,8
CA,2022,Small Mammals,35,33,33,101
CO,2000,Dogs,0,0,0,0
CO,2008,Cats,0,0,0,0
CO,2008,Dogs,0,0,0,0
CO,2009,Cats,0,0,0,0
CO,2009,Dogs,0,0,0,0
CO,2010,Cats,0,0,0,0
CO,2010,Dogs,0,0,0,0
CO,2011,Cats,0,0,0,0
CO,2011,Dogs,2,0,0,2
CO,2012,Cats,8,2,3,13
CO,2012,Dogs,9,2,1,12
CO,2013,Cats,57,53,1,111
CO,2013,Dogs,47,6,0,53
CO,2014,Cats,71,79,13,163
CO,2014,Dogs,59,12,4,75
CO,2015,Cats,72,63,23,158
CO,2015,Dogs,147,24,7,178
CO,2015,Rabbits,0,0,0,0
CO,2015,Small Mammals,0,1,0,1
CO,2016,Cats,1032,365,122,1519
CO,2016,Dogs,1468,60,103,1631
CO,2017,Cats,1280,269,86,1635
CO,2017,Dogs,1584,38,173,1795
CO,2018,Cats,1155,308,83,1546
CO,2018,Dogs,1758,40,124,1922
CO,2019,Cats,1158,447,105,1710
CO,2019,Dogs,1663,60,109,1832
CO,2020,Cats,913,234,49,1196
CO,2020,Dogs,1148,31,52,1231
CO,2020,Farm Animals,0,0,0,0
CO,2020,Rabbits,0,0,0,0
CO,2021,Birds,4,1,65,70
CO,2021,Cats,891,402,55,1348
CO,2021,Dogs,998,35,49,1082
CO,2021,Equine,0,0,0,0
CO,2021,Farm Animals,0,0,0,0
CO,2021,Rabbits,2,7,39,48
CO,2021,Reptiles & Amphibians,0,0,6,6
CO,2021,Small Mammals,7,6,110,123
CO,2022,Birds,1,0,7,8
CO,2022,Cats,106,12,3,121
CO,2022,Dogs,169,11,3,183
CO,2022,Equine,0,0,0,0
CO,2022,Farm Animals,0,0,0,0
CO,2022,Rabbits,0,0,0,0
CO,2022,Reptiles & Amphibians,0,0,1,1
CO,2022,Small Mammals,2,0,5,7
CT,2013,Cats,3,2,0,5
CT,2013,Dogs,0,0,0,0
CT,2014,Cats,12,1,0,13
CT,2014,Dogs,3,0,0,3
CT,2015,Cats,13,1,0,14
CT,2015,Dogs,4,0,0,4
CT,2016,Cats,138,40,39,217
CT,2016,Dogs,60,9,1,70
CT,2017,Cats,80,21,21,122
CT,2017,Dogs,65,6,0,71
CT,2018,Birds,0,0,0,0
CT,2018,Cats,75,21,19,115
CT,2018,Dogs,59,3,1,63
CT,2018,Farm Animals,0,0,0,0
CT,2018,Rabbits,0,0,0,0
CT,2018,Reptiles & Amphibians,0,0,0,0
CT,2018,Small Mammals,0,0,0,0
CT,2019,Birds,0,0,0,0
CT,2019,Cats,80,16,53,149
CT,2019,Dogs,40,1,11,52
CT,2019,Farm Animals,0,0,0,0
CT,2019,Rabbits,0,0,0,0
CT,2019,Reptiles & Amphibians,0,0,0,0
CT,2019,Small Mammals,0,0,0,0
CT,2020,Birds,0,0,0,0
CT,2020,Cats,69,37,10,116
CT,2020,Dogs,24,3,5,32
CT,2020,Equine,0,0,0,0
CT,2020,Farm Animals,0,0,0,0
CT,2020,Rabbits,0,0,0,0
CT,2020,Reptiles & Amphibians,0,0,0,0
CT,2020,Small Mammals,0,0,0,0
CT,2021,Birds,0,0,0,0
CT,2021,Cats,56,17,13,86
CT,2021,Dogs,27,11,8,46
CT,2021,Equine,0,0,0,0
CT,2021,Farm Animals,0,0,0,0
CT,2021,Rabbits,3,0,0,3
CT,2021,Reptiles & Amphibians,0,0,0,0
CT,2021,Small Mammals,7,0,0,7
CT,2022,Birds,0,0,0,0
CT,2022,Cats,16,0,6,22
CT,2022,Dogs,3,0,2,5
CT,2022,Farm Animals,0,0,0,0
CT,2022,Rabbits,0,0,0,0
CT,2022,Reptiles & Amphibians,0,0,0,0
CT,2022,Small Mammals,4,0,0,4
DC,2015,Cats,183,184,83,450
DC,2015,Dogs,381,1,39,421
DC,2016,Cats,200,66,54,320
DC,2016,Dogs,503,17,19,539
DC,2017,Cats,177,48,62,287
DC,2017,Dogs,378,6,14,398
DC,2018,Cats,158,49,100,307
DC,2018,Dogs,309,6,19,334
DC,2019,Cats,140,55,82,277
DC,2019,Dogs,290,6,19,315
DC,2020,Cats,105,54,71,230
DC,2020,Dogs,175,2,16,193
DC,2021,Birds,0,2,4,6
DC,2021,Cats,112,47,82,241
DC,2021,Dogs,142,5,21,168
DC,2021,Reptiles & Amphibians,0,0,2,2
DC,2021,Small Mammals,1,0,3,4
DC,2022,Birds,0,0,0,0
DC,2022,Cats,18,1,19,38
DC,2022,Dogs,38,2,6,46
DC,2022,Reptiles & Amphibians,0,0,1,1
DC,2022,Small Mammals,0,1,2,3
DE,2013,Cats,33,0,0,33
DE,2013,Dogs,4,0,0,4
DE,2014,Cats,36,0,0,36
DE,2014,Dogs,2,0,0,2
DE,2015,Cats,40,0,0,40
DE,2015,Dogs,6,0,0,6
DE,2016,Cats,65,25,165,255
DE,2016,Dogs,27,8,218,253
DE,2017,Cats,98,30,83,211
DE,2017,Dogs,22,9,223,254
DE,2018,Cats,72,28,184,284
DE,2018,Dogs,33,5,282,320
DE,2019,Cats,64,27,192,283
DE,2019,Dogs,12,0,245,257
DE,2020,Cats,58,46,238,342
DE,2020,Dogs,32,5,228,265
DE,2021,Birds,0,0,0,0
DE,2021,Cats,73,39,34,146
DE,2021,Dogs,31,5,39,75
DE,2021,Equine,0,0,0,0
DE,2021,Farm Animals,0,0,0,0
DE,2021,Rabbits,0,0,0,0
DE,2021,Reptiles & Amphibians,0,0,0,0
DE,2021,Small Mammals,0,0,0,0
DE,2022,Birds,0,0,0,0
DE,2022,Cats,15,0,0,15
DE,2022,Dogs,4,1,0,5
DE,2022,Equine,0,0,0,0
DE,2022,Farm Animals,0,0,0,0
DE,2022,Rabbits,0,0,0,0
DE,2022,Reptiles & Amphibians,0,0,0,0
DE,2022,Small Mammals,0,0,0,0
FL,2011,Cats,1353,1878,14336,17567
FL,2011,Dogs,1231,85,7300,8616
FL,2012,Cats,3297,2634,10255,16186
FL,2012,Dogs,1537,48,4952,6537
FL,2013,Cats,3806,2277,10485,16568
FL,2013,Dogs,1173,15,5360,6548
FL,2014,Cats,3918,2659,3192,9769
FL,2014,Dogs,2409,57,2589,5055
FL,2015,Cats,4710,2513,3557,10780
FL,2015,Dogs,3110,235,2462,5807
FL,2016,Cats,8509,5573,6361,20443
FL,2016,Dogs,6193,278,2447,8918
FL,2017,Cats,6499,4736,8780,20015
FL,2017,Dogs,5029,297,2709,8035
FL,2018,Cats,10200,7711,9198,27109
FL,2018,Dogs,7301,383,2744,10428
FL,2019,Birds,0,0,0,0
FL,2019,Cats,7452,7285,7362,22099
FL,2019,Dogs,6088,287,2114,8489
FL,2019,Equine,0,0,0,0
FL,2019,Farm Animals,0,0,0,0
FL,2019,Rabbits,0,0,0,0
FL,2019,Reptiles & Amphibians,0,0,0,0
FL,2019,Small Mammals,0,0,0,0
FL,2020,Birds,0,0,0,0
FL,2020,Cats,4166,2731,4020,10917
FL,2020,Dogs,3166,132,1467,4765
FL,2020,Equine,0,0,0,0
FL,2020,Farm Animals,0,0,0,0
FL,2020,Rabbits,0,0,0,0
FL,2020,Reptiles & Amphibians,0,0,0,0
FL,2020,Small Mammals,0,0,0,0
FL,2021,Birds,4,0,2,6
FL,2021,Cats,4441,3478,2451,10370
FL,2021,Dogs,3312,225,751,4288
FL,2021,Equine,0,0,0,0
FL,2021,Farm Animals,1,0,5,6
FL,2021,Rabbits,6,3,7,16
FL,2021,Reptiles & Amphibians,0,0,0,0
FL,2021,Small Mammals,13,11,1,25
FL,2022,Birds,0,0,0,0
FL,2022,Cats,670,135,251,1056
FL,2022,Dogs,585,25,130,740
FL,2022,Equine,1,0,0,1
FL,2022,Farm Animals,0,0,0,0
FL,2022,Rabbits,7,0,0,7
FL,2022,Reptiles & Amphibians,0,0,0,0
FL,2022,Small Mammals,4,0,2,6
GA,2011,Cats,262,176,50,488
GA,2011,Dogs,229,58,17,304
GA,2012,Cats,98,88,443,629
GA,2012,Dogs,130,85,73,288
GA,2013,Cats,1281,1418,1074,3773
GA,2013,Dogs,1538,369,553,2460
GA,2014,Cats,620,644,1160,2424
GA,2014,Dogs,726,112,1337,2175
GA,2015,Cats,963,857,301,2121
GA,2015,Dogs,1632,114,77,1823
GA,2015,Farm Animals,0,0,1,1
GA,2015,Rabbits,0,0,1,1
GA,2015,Small Mammals,0,0,1,1
GA,2016,Cats,2584,2297,1963,6844
GA,2016,Dogs,3833,382,1533,5748
GA,2016,Farm Animals,0,0,0,0
GA,2016,Rabbits,0,0,0,0
GA,2016,Small Mammals,0,0,0,0
GA,2017,Birds,0,0,0,0
GA,2017,Cats,3249,2149,1287,6685
GA,2017,Dogs,5090,287,1182,6559
GA,2017,Farm Animals,0,0,0,0
GA,2017,Rabbits,0,0,0,0
GA,2017,Small Mammals,0,0,0,0
GA,2018,Birds,0,0,1,1
GA,2018,Cats,5949,3090,1153,10192
GA,2018,Dogs,7142,387,1189,8718
GA,2018,Equine,0,0,0,0
GA,2018,Farm Animals,0,0,0,0
GA,2018,Rabbits,0,0,0,0
GA,2018,Reptiles & Amphibians,0,0,0,0
GA,2018,Small Mammals,0,0,1,1
GA,2019,Birds,0,0,0,0
GA,2019,Cats,5744,2715,870,9329
GA,2019,Dogs,5924,495,749,7168
GA,2019,Farm Animals,0,0,0,0
GA,2019,Rabbits,0,0,0,0
GA,2019,Small Mammals,0,0,0,0
GA,2020,Birds,0,0,0,0
GA,2020,Cats,2999,1479,566,5044
GA,2020,Dogs,2711,167,454,3332
GA,2020,Equine,0,0,0,0
GA,2020,Farm Animals,0,0,0,0
GA,2020,Rabbits,0,0,0,0
GA,2020,Reptiles & Amphibians,0,0,0,0
GA,2020,Small Mammals,0,0,0,0
GA,2021,Birds,1,0,0,1
GA,2021,Cats,1484,1469,304,3257
GA,2021,Dogs,2042,113,223,2378
GA,2021,Equine,0,0,0,0
GA,2021,Farm Animals,0,0,2,2
GA,2021,Rabbits,1,0,1,2
GA,2021,Reptiles & Amphibians,0,0,0,0
GA,2021,Small Mammals,0,0,0,0
GA,2022,Birds,0,0,1,1
GA,2022,Cats,200,45,27,272
GA,2022,Dogs,343,13,30,386
GA,2022,Equine,0,0,0,0
GA,2022,Farm Animals,0,0,0,0
GA,2022,Rabbits,0,0,1,1
GA,2022,Reptiles & Amphibians,0,0,0,0
GA,2022,Small Mammals,0,0,0,0
HI,2013,Cats,4311,0,0,4311
HI,2013,Dogs,3242,0,0,3242
HI,2014,Cats,4814,0,0,4814
HI,2014,Dogs,3638,0,0,3638
HI,2015,Cats,5317,76,25,5418
HI,2015,Dogs,2895,2,11,2908
HI,2016,Cats,5555,2705,2454,10714
HI,2016,Dogs,2608,123,136,2867
HI,2017,Cats,6032,5610,403,12045
HI,2017,Dogs,2017,193,27,2237
HI,2018,Cats,4590,5057,672,10319
HI,2018,Dogs,1688,110,63,1861
HI,2019,Cats,4018,3447,255,7720
HI,2019,Dogs,1069,96,15,1180
HI,2020,Birds,0,0,0,0
HI,2020,Cats,1858,1826,6,3690
HI,2020,Dogs,740,58,0,798
HI,2020,Equine,0,0,0,0
HI,2020,Farm Animals,0,0,0,0
HI,2020,Rabbits,0,0,0,0
HI,2020,Reptiles & Amphibians,0,0,0,0
HI,2020,Small Mammals,0,0,0,0
HI,2021,Birds,94,58,71,223
HI,2021,Cats,951,1976,0,2927
HI,2021,Dogs,752,49,0,801
HI,2021,Equine,0,0,0,0
HI,2021,Farm Animals,78,69,130,277
HI,2021,Rabbits,26,1,2,29
HI,2021,Reptiles & Amphibians,2,0,2,4
HI,2021,Small Mammals,65,45,20,130
HI,2022,Birds,9,7,0,16
HI,2022,Cats,147,94,1,242
HI,2022,Dogs,248,21,3,272
HI,2022,Equine,0,0,0,0
HI,2022,Farm Animals,0,0,0,0
HI,2022,Rabbits,13,2,0,15
HI,2022,Reptiles & Amphibians,0,0,0,0
HI,2022,Small Mammals,8,1,0,9
IA,2012,Cats,0,0,0,0
IA,2012,Dogs,0,0,0,0
IA,2013,Birds,0,0,1,1
IA,2013,Cats,210,613,794,1617
IA,2013,Dogs,83,7,250,340
IA,2013,Rabbits,0,1,10,11
IA,2013,Reptiles & Amphibians,0,0,0,0
IA,2013,Small Mammals,0,0,8,8
IA,2014,Birds,0,0,1,1
IA,2014,Cats,169,494,619,1282
IA,2014,Dogs,68,10,231,309
IA,2014,Rabbits,0,1,2,3
IA,2014,Reptiles & Amphibians,0,0,1,1
IA,2014,Small Mammals,4,6,1,11
IA,2015,Birds,0,0,1,1
IA,2015,Cats,631,515,536,1682
IA,2015,Dogs,132,14,175,321
IA,2015,Rabbits,0,0,1,1
IA,2015,Small Mammals,2,0,8,10
IA,2016,Birds,0,0,0,0
IA,2016,Cats,1420,806,475,2701
IA,2016,Dogs,653,29,171,853
IA,2016,Rabbits,0,0,1,1
IA,2016,Small Mammals,5,0,1,6
IA,2017,Birds,0,0,0,0
IA,2017,Cats,1257,708,365,2330
IA,2017,Dogs,579,15,123,717
IA,2017,Rabbits,0,0,1,1
IA,2017,Small Mammals,1,0,0,1
IA,2018,Birds,0,0,0,0
IA,2018,Cats,1077,557,159,1793
IA,2018,Dogs,605,12,107,724
IA,2018,Rabbits,0,0,0,0
IA,2018,Reptiles & Amphibians,0,0,0,0
IA,2018,Small Mammals,0,0,0,0
IA,2019,Birds,0,0,0,0
IA,2019,Cats,1152,770,185,2107
IA,2019,Dogs,600,20,77,697
IA,2019,Rabbits,0,0,0,0
IA,2019,Small Mammals,0,0,1,1
IA,2020,Birds,0,0,0,0
IA,2020,Cats,788,320,144,1252
IA,2020,Dogs,428,30,40,498
IA,2020,Equine,0,0,0,0
IA,2020,Farm Animals,0,0,0,0
IA,2020,Rabbits,1,0,0,1
IA,2020,Reptiles & Amphibians,0,0,0,0
IA,2020,Small Mammals,1,0,0,1
IA,2021,Birds,1,0,0,1
IA,2021,Cats,573,288,168,1029
IA,2021,Dogs,420,18,59,497
IA,2021,Equine,3,0,0,3
IA,2021,Farm Animals,0,0,4,4
IA,2021,Rabbits,0,2,8,10
IA,2021,Reptiles & Amphibians,0,0,2,2
IA,2021,Small Mammals,6,0,6,12
IA,2022,Birds,0,0,2,2
IA,2022,Cats,67,8,18,93
IA,2022,Dogs,56,3,9,68
IA,2022,Equine,1,0,0,1
IA,2022,Farm Animals,0,0,0,0
IA,2022,Rabbits,0,0,0,0
IA,2022,Reptiles & Amphibians,0,0,0,0
IA,2022,Small Mammals,0,0,3,3
ID,2011,Cats,14,44,20,78
ID,2011,Dogs,2,6,11,19
ID,2012,Cats,7,20,1,28
ID,2012,Dogs,0,4,0,4
ID,2013,Cats,15,42,8,65
ID,2013,Dogs,4,0,2,6
ID,2014,Cats,18,32,14,64
ID,2014,Dogs,0,0,3,3
ID,2015,Cats,235,203,17,455
ID,2015,Dogs,16,4,1,21
ID,2016,Cats,1105,784,265,2154
ID,2016,Dogs,121,4,64,189
ID,2017,Cats,2102,1959,338,4399
ID,2017,Dogs,401,22,3,426
ID,2018,Cats,1783,2138,1425,5346
ID,2018,Dogs,509,28,27,564
ID,2019,Cats,1395,1634,1327,4356
ID,2019,Dogs,445,40,96,581
ID,2020,Cats,741,557,1078,2376
ID,2020,Dogs,268,13,1,282
ID,2021,Birds,0,0,0,0
ID,2021,Cats,579,395,272,1246
ID,2021,Dogs,131,31,2,164
ID,2021,Equine,0,0,0,0
ID,2021,Farm Animals,0,0,0,0
ID,2021,Rabbits,1,0,0,1
ID,2021,Reptiles & Amphibians,0,0,0,0
ID,2021,Small Mammals,0,0,0,0
ID,2022,Birds,0,0,0,0
ID,2022,Cats,73,15,2,90
ID,2022,Dogs,20,2,1,23
ID,2022,Equine,0,0,0,0
ID,2022,Farm Animals,0,0,0,0
ID,2022,Rabbits,0,0,0,0
ID,2022,Reptiles & Amphibians,0,0,0,0
ID,2022,Small Mammals,0,0,0,0
IL,2011,Cats,1,0,0,1
IL,2011,Dogs,2,0,0,2
IL,2012,Cats,0,8,0,8
IL,2012,Dogs,3,0,0,3
IL,2013,Cats,1,1,0,2
IL,2013,Dogs,19,7,0,26
IL,2014,Cats,8,15,0,23
IL,2014,Dogs,55,4,0,59
IL,2015,Cats,650,255,364,1269
IL,2015,Dogs,480,10,327,817
IL,2016,Cats,1543,534,1164,3241
IL,2016,Dogs,1237,31,2031,3299
IL,2017,Cats,1058,410,1340,2808
IL,2017,Dogs,778,88,1310,2176
IL,2018,Cats,1305,500,1374,3179
IL,2018,Dogs,866,163,1445,2474
IL,2019,Cats,2003,810,1180,3993
IL,2019,Dogs,1507,175,1000,2682
IL,2020,Birds,0,0,0,0
IL,2020,Cats,1293,407,741,2441
IL,2020,Dogs,1075,172,457,1704
IL,2020,Equine,0,0,0,0
IL,2020,Farm Animals,0,0,0,0
IL,2020,Rabbits,0,0,0,0
IL,2020,Reptiles & Amphibians,0,0,0,0
IL,2020,Small Mammals,0,0,0,0
IL,2021,Birds,0,0,0,0
IL,2021,Cats,1132,497,260,1889
IL,2021,Dogs,919,131,119,1169
IL,2021,Equine,2,0,0,2
IL,2021,Farm Animals,0,0,0,0
IL,2021,Rabbits,2,1,1,4
IL,2021,Reptiles & Amphibians,0,0,1,1
IL,2021,Small Mammals,3,0,3,6
IL,2022,Birds,0,0,0,0
IL,2022,Cats,181,26,29,236
IL,2022,Dogs,178,5,24,207
IL,2022,Equine,0,0,0,0
IL,2022,Farm Animals,0,0,0,0
IL,2022,Rabbits,1,0,0,1
IL,2022,Reptiles & Amphibians,0,0,0,0
IL,2022,Small Mammals,1,0,0,1
IN,2011,Cats,1003,892,13,1908
IN,2011,Dogs,605,145,13,763
IN,2012,Cats,856,585,8,1449
IN,2012,Dogs,379,21,1,401
IN,2013,Cats,827,682,8,1517
IN,2013,Dogs,340,14,0,354
IN,2014,Cats,1744,1070,191,3005
IN,2014,Dogs,817,23,108,948
IN,2015,Cats,4118,2471,688,7277
IN,2015,Dogs,1668,55,1820,3543
IN,2016,Cats,4811,2544,1104,8459
IN,2016,Dogs,2281,70,1467,3818
IN,2017,Birds,0,0,0,0
IN,2017,Cats,3555,1651,1117,6323
IN,2017,Dogs,2010,53,1585,3648
IN,2017,Rabbits,2,0,2,4
IN,2017,Reptiles & Amphibians,0,0,0,0
IN,2017,Small Mammals,2,0,0,2
IN,2018,Birds,0,0,0,0
IN,2018,Cats,2923,1797,1077,5797
IN,2018,Dogs,2023,70,879,2972
IN,2018,Rabbits,0,0,3,3
IN,2018,Reptiles & Amphibians,0,0,0,0
IN,2018,Small Mammals,4,0,0,4
IN,2019,Birds,0,0,0,0
IN,2019,Cats,2234,1405,1225,4864
IN,2019,Dogs,1748,54,1001,2803
IN,2019,Rabbits,0,0,0,0
IN,2019,Reptiles & Amphibians,0,0,0,0
IN,2019,Small Mammals,4,0,1,5
IN,2020,Birds,0,0,1,1
IN,2020,Cats,1382,704,763,2849
IN,2020,Dogs,1070,32,509,1611
IN,2020,Rabbits,0,0,0,0
IN,2020,Small Mammals,2,0,0,2
IN,2021,Birds,29,0,0,29
IN,2021,Cats,1648,1120,688,3456
IN,2021,Dogs,1488,33,186,1707
IN,2021,Equine,0,0,0,0
IN,2021,Farm Animals,0,0,0,0
IN,2021,Rabbits,50,1,1,52
IN,2021,Reptiles & Amphibians,4,0,0,4
IN,2021,Small Mammals,27,1,0,28
IN,2022,Birds,3,0,0,3
IN,2022,Cats,330,29,27,386
IN,2022,Dogs,305,12,9,326
IN,2022,Equine,0,0,0,0
IN,2022,Farm Animals,0,0,0,0
IN,2022,Rabbits,4,0,1,5
IN,2022,Reptiles & Amphibians,1,0,0,1
IN,2022,Small Mammals,7,12,0,19
KS,2012,Cats,1287,1050,427,2764
KS,2012,Dogs,1427,144,24,1595
KS,2013,Cats,989,959,276,2224
KS,2013,Dogs,1128,113,31,1272
KS,2014,Cats,924,582,208,1714
KS,2014,Dogs,875,43,13,931
KS,2015,Cats,797,569,323,1689
KS,2015,Dogs,739,24,16,779
KS,2016,Cats,1216,1152,248,2616
KS,2016,Dogs,1133,87,54,1274
KS,2017,Cats,1317,1153,737,3207
KS,2017,Dogs,1182,185,135,1502
KS,2018,Cats,1073,725,1069,2867
KS,2018,Dogs,1083,165,275,1523
KS,2019,Birds,0,0,0,0
KS,2019,Cats,1075,1140,600,2815
KS,2019,Dogs,1053,147,143,1343
KS,2019,Equine,0,0,0,0
KS,2019,Farm Animals,0,0,0,0
KS,2019,Rabbits,0,0,1,1
KS,2019,Reptiles & Amphibians,0,0,0,0
KS,2019,Small Mammals,0,0,0,0
KS,2020,Birds,0,0,0,0
KS,2020,Cats,608,567,317,1492
KS,2020,Dogs,703,97,115,915
KS,2020,Equine,0,0,0,0
KS,2020,Farm Animals,0,0,0,0
KS,2020,Rabbits,0,0,0,0
KS,2020,Reptiles & Amphibians,0,0,0,0
KS,2020,Small Mammals,0,0,0,0
KS,2021,Birds,0,0,5,5
KS,2021,Cats,461,568,144,1173
KS,2021,Dogs,806,125,51,982
KS,2021,Equine,0,0,0,0
KS,2021,Farm Animals,0,0,0,0
KS,2021,Rabbits,0,0,1,1
KS,2021,Reptiles & Amphibians,1,0,0,1
KS,2021,Small Mammals,0,0,0,0
KS,2022,Birds,0,0,0,0
KS,2022,Cats,14,4,0,18
KS,2022,Dogs,39,9,0,48
KS,2022,Equine,0,0,0,0
KS,2022,Farm Animals,0,0,0,0
KS,2022,Rabbits,0,0,0,0
KS,2022,Reptiles & Amphibians,0,0,0,0
KS,2022,Small Mammals,1,0,0,1
KY,2011,Cats,549,763,1225,2537
KY,2011,Dogs,572,92,127,791
KY,2012,Cats,485,845,889,2219
KY,2012,Dogs,446,64,136,646
KY,2013,Cats,510,957,816,2283
KY,2013,Dogs,435,47,95,577
KY,2014,Cats,458,723,518,1699
KY,2014,Dogs,343,52,105,500
KY,2015,Cats,1423,2080,997,4500
KY,2015,Dogs,1432,616,85,2133
KY,2015,Rabbits,1,0,3,4
KY,2015,Reptiles & Amphibians,0,0,0,0
KY,2015,Small Mammals,0,0,4,4
KY,2016,Cats,3389,4217,1717,9323
KY,2016,Dogs,2003,535,155,2693
KY,2016,Rabbits,7,2,26,35
KY,2016,Small Mammals,2,0,8,10
KY,2017,Cats,3040,3620,1377,8037
KY,2017,Dogs,2115,392,259,2766
KY,2017,Rabbits,16,5,15,36
KY,2017,Small Mammals,3,15,3,21
KY,2018,Cats,2861,3139,2105,8105
KY,2018,Dogs,2423,325,542,3290
KY,2018,Rabbits,5,0,21,26
KY,2018,Reptiles & Amphibians,0,0,0,0
KY,2018,Small Mammals,3,0,4,7
KY,2019,Cats,2305,2589,2015,6909
KY,2019,Dogs,2036,188,465,2689
KY,2019,Rabbits,4,0,14,18
KY,2019,Reptiles & Amphibians,0,0,0,0
KY,2019,Small Mammals,3,0,5,8
KY,2020,Birds,0,0,0,0
KY,2020,Cats,1439,1668,1075,4182
KY,2020,Dogs,1143,135,286,1564
KY,2020,Rabbits,2,1,7,10
KY,2020,Reptiles & Amphibians,0,0,0,0
KY,2020,Small Mammals,14,10,15,39
KY,2021,Birds,0,0,21,21
KY,2021,Cats,983,1397,746,3126
KY,2021,Dogs,1020,125,311,1456
KY,2021,Equine,0,0,0,0
KY,2021,Farm Animals,0,0,1,1
KY,2021,Rabbits,10,3,29,42
KY,2021,Reptiles & Amphibians,0,0,1,1
KY,2021,Small Mammals,0,0,10,10
KY,2022,Birds,0,0,2,2
KY,2022,Cats,136,17,30,183
KY,2022,Dogs,255,58,37,350
KY,2022,Equine,0,0,0,0
KY,2022,Farm Animals,0,0,0,0
KY,2022,Rabbits,1,0,7,8
KY,2022,Reptiles & Amphibians,0,0,0,0
KY,2022,Small Mammals,2,0,0,2
LA,2011,Cats,1365,0,0,1365
LA,2011,Dogs,1196,0,0,1196
LA,2012,Cats,1478,0,0,1478
LA,2012,Dogs,1142,0,0,1142
LA,2013,Cats,1090,6,0,1096
LA,2013,Dogs,535,1,0,536
LA,2014,Cats,790,6,0,796
LA,2014,Dogs,423,1,0,424
LA,2015,Cats,2143,1084,13,3240
LA,2015,Dogs,1366,66,2,1434
LA,2016,Cats,4389,4463,229,9081
LA,2016,Dogs,4863,690,255,5808
LA,2017,Birds,0,0,0,0
LA,2017,Cats,5776,4355,1825,11956
LA,2017,Dogs,5638,838,1747,8223
LA,2017,Equine,0,0,0,0
LA,2017,Farm Animals,0,0,0,0
LA,2017,Rabbits,0,0,0,0
LA,2017,Reptiles & Amphibians,0,0,0,0
LA,2017,Small Mammals,15,8,0,23
LA,2018,Birds,0,0,0,0
LA,2018,Cats,4125,3420,2527,10072
LA,2018,Dogs,4726,688,2654,8068
LA,2018,Equine,0,0,0,0
LA,2018,Farm Animals,0,0,0,0
LA,2018,Rabbits,0,0,0,0
LA,2018,Reptiles & Amphibians,0,0,0,0
LA,2018,Small Mammals,1,4,0,5
LA,2019,Birds,0,0,0,0
LA,2019,Cats,3232,2802,2690,8724
LA,2019,Dogs,4330,327,1668,6325
LA,2019,Equine,0,0,0,0
LA,2019,Farm Animals,0,0,0,0
LA,2019,Rabbits,0,0,0,0
LA,2019,Reptiles & Amphibians,0,0,0,0
LA,2019,Small Mammals,2,9,0,11
LA,2020,Birds,1,0,0,1
LA,2020,Cats,924,687,2943,4554
LA,2020,Dogs,2136,100,2009,4245
LA,2020,Equine,0,0,0,0
LA,2020,Farm Animals,0,0,0,0
LA,2020,Rabbits,0,0,0,0
LA,2020,Reptiles & Amphibians,0,0,0,0
LA,2020,Small Mammals,0,0,0,0
LA,2021,Birds,4,0,0,4
LA,2021,Cats,793,634,962,2389
LA,2021,Dogs,1764,143,360,2267
LA,2021,Equine,1,0,0,1
LA,2021,Farm Animals,0,0,0,0
LA,2021,Rabbits,0,0,0,0
LA,2021,Reptiles & Amphibians,0,0,1,1
LA,2021,Small Mammals,10,0,0,10
LA,2022,Birds,0,0,0,0
LA,2022,Cats,108,36,149,293
LA,2022,Dogs,430,12,96,538
LA,2022,Equine,0,0,0,0
LA,2022,Farm Animals,0,0,2,2
LA,2022,Rabbits,0,0,0,0
LA,2022,Reptiles & Amphibians,0,0,0,0
LA,2022,Small Mammals,1,0,0,1
MA,2013,Cats,15,5,0,20
MA,2013,Dogs,0,0,0,0
MA,2014,Cats,33,3,0,36
MA,2014,Dogs,0,0,0,0
MA,2015,Cats,97,4,0,101
MA,2015,Dogs,76,1,0,77
MA,2016,Cats,1061,155,22,1238
MA,2016,Dogs,511,7,6,524
MA,2017,Cats,668,100,36,804
MA,2017,Dogs,355,17,18,390
MA,2018,Cats,711,125,13,849
MA,2018,Dogs,394,12,1,407
MA,2019,Cats,598,82,13,693
MA,2019,Dogs,346,4,0,350
MA,2020,Birds,0,0,0,0
MA,2020,Cats,525,63,27,615
MA,2020,Dogs,378,9,14,401
MA,2020,Rabbits,0,0,0,0
MA,2020,Reptiles & Amphibians,0,0,0,0
MA,2020,Small Mammals,0,0,0,0
MA,2021,Birds,7,0,0,7
MA,2021,Cats,464,70,21,555
MA,2021,Dogs,319,10,4,333
MA,2021,Equine,0,0,0,0
MA,2021,Farm Animals,10,0,0,10
MA,2021,Rabbits,9,1,0,10
MA,2021,Reptiles & Amphibians,2,0,0,2
MA,2021,Small Mammals,75,11,3,89
MA,2022,Birds,0,0,0,0
MA,2022,Cats,35,3,1,39
MA,2022,Dogs,40,0,1,41
MA,2022,Equine,0,0,0,0
MA,2022,Farm Animals,1,0,0,1
MA,2022,Rabbits,1,0,0,1
MA,2022,Reptiles & Amphibians,0,0,0,0
MA,2022,Small Mammals,0,0,0,0
MD,2013,Cats,932,254,0,1186
MD,2013,Dogs,1142,25,0,1167
MD,2014,Cats,960,230,1,1191
MD,2014,Dogs,1140,32,0,1172
MD,2015,Cats,801,230,3,1034
MD,2015,Dogs,808,26,0,834
MD,2016,Cats,1075,600,815,2490
MD,2016,Dogs,809,19,232,1060
MD,2017,Cats,1848,834,1355,4037
MD,2017,Dogs,776,18,334,1128
MD,2018,Cats,2034,961,807,3802
MD,2018,Dogs,1064,12,131,1207
MD,2019,Cats,2519,985,1480,4984
MD,2019,Dogs,1816,36,170,2022
MD,2020,Birds,0,0,0,0
MD,2020,Cats,1508,553,899,2960
MD,2020,Dogs,1118,30,223,1371
MD,2020,Equine,0,0,0,0
MD,2020,Rabbits,0,0,0,0
MD,2021,Birds,0,0,19,19
MD,2021,Cats,1556,1028,501,3085
MD,2021,Dogs,1463,59,125,1647
MD,2021,Equine,0,0,0,0
MD,2021,Farm Animals,2,0,0,2
MD,2021,Rabbits,7,0,0,7
MD,2021,Reptiles & Amphibians,0,0,0,0
MD,2021,Small Mammals,11,0,26,37
MD,2022,Birds,0,0,5,5
MD,2022,Cats,193,31,62,286
MD,2022,Dogs,373,16,50,439
MD,2022,Equine,0,0,0,0
MD,2022,Farm Animals,0,0,0,0
MD,2022,Rabbits,1,0,0,1
MD,2022,Reptiles & Amphibians,0,0,0,0
MD,2022,Small Mammals,3,0,3,6
ME,2014,Cats,30,0,31,61
ME,2014,Dogs,7,0,10,17
ME,2015,Cats,65,28,37,130
ME,2015,Dogs,61,0,14,75
ME,2016,Cats,131,34,102,267
ME,2016,Dogs,89,2,11,102
ME,2017,Cats,197,46,42,285
ME,2017,Dogs,111,4,7,122
ME,2018,Cats,228,78,86,392
ME,2018,Dogs,140,7,26,173
ME,2019,Cats,157,51,14,222
ME,2019,Dogs,129,3,4,136
ME,2020,Cats,165,39,10,214
ME,2020,Dogs,83,1,1,85
ME,2021,Birds,0,0,0,0
ME,2021,Cats,109,32,14,155
ME,2021,Dogs,51,5,3,59
ME,2021,Equine,0,0,0,0
ME,2021,Farm Animals,0,0,0,0
ME,2021,Rabbits,1,0,0,1
ME,2021,Reptiles & Amphibians,0,0,0,0
ME,2021,Small Mammals,2,0,0,2
ME,2022,Birds,4,0,0,4
ME,2022,Cats,13,4,0,17
ME,2022,Dogs,15,0,0,15
ME,2022,Equine,0,0,0,0
ME,2022,Farm Animals,0,0,0,0
ME,2022,Rabbits,2,0,0,2
ME,2022,Reptiles & Amphibians,0,0,0,0
ME,2022,Small Mammals,1,0,0,1
MI,2011,Cats,0,0,0,0
MI,2011,Dogs,0,0,0,0
MI,2012,Cats,0,0,21,21
MI,2012,Dogs,0,0,114,114
MI,2013,Cats,290,125,409,824
MI,2013,Dogs,243,10,174,427
MI,2014,Cats,455,275,160,890
MI,2014,Dogs,381,7,144,532
MI,2015,Cats,454,197,42,693
MI,2015,Dogs,289,3,67,359
MI,2016,Cats,667,202,13,882
MI,2016,Dogs,681,18,21,720
MI,2017,Birds,4,0,8,12
MI,2017,Cats,1226,381,683,2290
MI,2017,Dogs,1542,86,708,2336
MI,2017,Rabbits,5,0,5,10
MI,2017,Reptiles & Amphibians,0,0,0,0
MI,2017,Small Mammals,3,2,8,13
MI,2018,Cats,1400,896,90,2386
MI,2018,Dogs,2301,91,89,2481
MI,2019,Cats,1305,672,67,2044
MI,2019,Dogs,3079,94,109,3282
MI,2020,Birds,4,0,427,431
MI,2020,Cats,932,445,197,1574
MI,2020,Dogs,1826,55,260,2141
MI,2020,Equine,0,0,0,0
MI,2020,Farm Animals,0,0,0,0
MI,2020,Rabbits,4,1,1,6
MI,2020,Reptiles & Amphibians,1,0,0,1
MI,2020,Small Mammals,11,1,0,12
MI,2021,Birds,1,0,168,169
MI,2021,Cats,549,405,245,1199
MI,2021,Dogs,980,71,429,1480
MI,2021,Equine,0,0,0,0
MI,2021,Farm Animals,0,0,2,2
MI,2021,Rabbits,8,1,5,14
MI,2021,Reptiles & Amphibians,0,0,1,1
MI,2021,Small Mammals,12,1,3,16
MI,2022,Birds,0,0,0,0
MI,2022,Cats,118,25,36,179
MI,2022,Dogs,197,7,101,305
MI,2022,Equine,0,0,0,0
MI,2022,Farm Animals,0,0,0,0
MI,2022,Rabbits,0,4,1,5
MI,2022,Reptiles & Amphibians,0,0,0,0
MI,2022,Small Mammals,5,0,0,5
MN,2013,Cats,3,1,38,42
MN,2013,Dogs,10,0,22,32
MN,2014,Cats,11,14,41,66
MN,2014,Dogs,23,1,32,56
MN,2015,Cats,355,145,27,527
MN,2015,Dogs,185,7,12,204
MN,2016,Cats,671,244,52,967
MN,2016,Dogs,527,82,33,642
MN,2017,Cats,825,359,210,1394
MN,2017,Dogs,710,50,24,784
MN,2018,Cats,1113,319,87,1519
MN,2018,Dogs,815,50,10,875
MN,2019,Cats,1035,343,26,1404
MN,2019,Dogs,762,67,9,838
MN,2020,Birds,0,0,0,0
MN,2020,Cats,558,193,49,800
MN,2020,Dogs,470,43,12,525
MN,2020,Equine,0,0,0,0
MN,2020,Farm Animals,0,0,0,0
MN,2020,Rabbits,0,0,0,0
MN,2020,Reptiles & Amphibians,0,0,0,0
MN,2020,Small Mammals,0,0,0,0
MN,2021,Birds,5,0,3,8
MN,2021,Cats,563,220,52,835
MN,2021,Dogs,640,52,21,713
MN,2021,Equine,0,0,0,0
MN,2021,Farm Animals,0,0,0,0
MN,2021,Rabbits,6,0,1,7
MN,2021,Reptiles & Amphibians,0,0,0,0
MN,2021,Small Mammals,19,1,1,21
MN,2022,Birds,0,0,0,0
MN,2022,Cats,76,14,8,98
MN,2022,Dogs,67,20,0,87
MN,2022,Equine,0,0,0,0
MN,2022,Farm Animals,0,0,0,0
MN,2022,Rabbits,1,2,0,3
MN,2022,Reptiles & Amphibians,0,0,0,0
MN,2022,Small Mammals,1,0,0,1
MO,2001,Dogs,0,0,0,0
MO,2011,Cats,18,1,0,19
MO,2011,Dogs,41,0,0,41
MO,2012,Cats,1,1,0,2
MO,2012,Dogs,0,0,0,0
MO,2013,Cats,4,0,0,4
MO,2013,Dogs,9,0,0,9
MO,2014,Cats,53,41,114,208
MO,2014,Dogs,201,4,105,310
MO,2015,Cats,153,38,129,320
MO,2015,Dogs,290,5,153,448
MO,2016,Cats,884,294,131,1309
MO,2016,Dogs,713,51,89,853
MO,2017,Cats,1895,846,140,2881
MO,2017,Dogs,990,68,94,1152
MO,2018,Cats,1836,535,641,3012
MO,2018,Dogs,943,56,232,1231
MO,2019,Birds,0,0,0,0
MO,2019,Cats,1381,1213,703,3297
MO,2019,Dogs,1200,209,212,1621
MO,2019,Equine,0,0,0,0
MO,2019,Farm Animals,0,0,0,0
MO,2019,Rabbits,0,0,0,0
MO,2019,Reptiles & Amphibians,0,0,0,0
MO,2019,Small Mammals,0,0,0,0
MO,2020,Birds,2,0,0,2
MO,2020,Cats,881,684,383,1948
MO,2020,Dogs,723,139,122,984
MO,2020,Equine,0,0,0,0
MO,2020,Farm Animals,0,0,0,0
MO,2020,Rabbits,0,0,0,0
MO,2020,Reptiles & Amphibians,0,0,0,0
MO,2020,Small Mammals,0,0,0,0
MO,2021,Birds,3,0,0,3
MO,2021,Cats,773,513,49,1335
MO,2021,Dogs,618,56,44,718
MO,2021,Equine,0,0,0,0
MO,2021,Farm Animals,1,0,0,1
MO,2021,Rabbits,0,0,0,0
MO,2021,Reptiles & Amphibians,0,0,0,0
MO,2021,Small Mammals,10,0,0,10
MO,2022,Birds,2,0,0,2
MO,2022,Cats,94,6,10,110
MO,2022,Dogs,118,13,19,150
MO,2022,Equine,0,0,0,0
MO,2022,Farm Animals,0,0,0,0
MO,2022,Rabbits,0,0,0,0
MO,2022,Reptiles & Amphibians,0,0,0,0
MO,2022,Small Mammals,0,0,0,0
MS,2011,Cats,795,586,859,2240
MS,2011,Dogs,1250,180,348,1778
MS,2012,Cats,336,326,1211,1873
MS,2012,Dogs,715,110,457,1282
MS,2013,Cats,426,990,1035,2451
MS,2013,Dogs,886,315,630,1831
MS,2014,Cats,429,746,547,1722
MS,2014,Dogs,923,368,659,1950
MS,2015,Cats,294,527,470,1291
MS,2015,Dogs,861,117,491,1469
MS,2016,Cats,486,845,413,1744
MS,2016,Dogs,1215,204,309,1728
MS,2017,Cats,530,1220,508,2258
MS,2017,Dogs,1288,505,309,2102
MS,2018,Cats,488,812,315,1615
MS,2018,Dogs,1270,589,324,2183
MS,2019,Cats,387,560,210,1157
MS,2019,Dogs,1040,166,256,1462
MS,2020,Birds,0,0,0,0
MS,2020,Cats,318,280,46,644
MS,2020,Dogs,520,119,76,715
MS,2020,Equine,0,0,0,0
MS,2020,Farm Animals,0,0,0,0
MS,2020,Rabbits,0,0,0,0
MS,2020,Reptiles & Amphibians,0,0,0,0
MS,2020,Small Mammals,0,0,0,0
MS,2021,Birds,0,0,0,0
MS,2021,Cats,268,248,56,572
MS,2021,Dogs,357,62,63,482
MS,2021,Equine,0,0,0,0
MS,2021,Farm Animals,0,1,0,1
MS,2021,Rabbits,0,0,0,0
MS,2021,Reptiles & Amphibians,0,0,0,0
MS,2021,Small Mammals,1,0,0,1
MS,2022,Birds,0,0,0,0
MS,2022,Cats,56,5,6,67
MS,2022,Dogs,131,10,23,164
MS,2022,Equine,0,0,0,0
MS,2022,Farm Animals,0,0,0,0
MS,2022,Rabbits,0,0,0,0
MS,2022,Reptiles & Amphibians,0,0,0,0
MS,2022,Small Mammals,0,0,0,0
MT,2011,Cats,5,0,1,6
MT,2011,Dogs,11,6,0,17
MT,2012,Cats,3,2,1,6
MT,2012,Dogs,7,0,0,7
MT,2013,Cats,5,0,2,7
MT,2013,Dogs,4,1,1,6
MT,2014,Cats,1,1,0,2
MT,2014,Dogs,1,0,0,1
MT,2015,Cats,2,0,0,2
MT,2015,Dogs,1,0,0,1
MT,2016,Cats,324,74,26,424
MT,2016,Dogs,139,3,8,150
MT,2017,Cats,754,267,12,1033
MT,2017,Dogs,308,20,1,329
MT,2018,Cats,703,286,35,1024
MT,2018,Dogs,236,20,0,256
MT,2019,Cats,525,186,17,728
MT,2019,Dogs,224,11,1,236
MT,2020,Cats,268,122,14,404
MT,2020,Dogs,198,10,2,210
MT,2021,Birds,0,0,0,0
MT,2021,Cats,284,118,2,404
MT,2021,Dogs,209,11,2,222
MT,2021,Equine,0,0,0,0
MT,2021,Farm Animals,0,0,0,0
MT,2021,Rabbits,0,0,0,0
MT,2021,Reptiles & Amphibians,0,0,0,0
MT,2021,Small Mammals,2,0,0,2
MT,2022,Birds,0,0,0,0
MT,2022,Cats,73,3,0,76
MT,2022,Dogs,38,1,0,39
MT,2022,Equine,0,0,0,0
MT,2022,Farm Animals,0,0,0,0
MT,2022,Rabbits,0,0,0,0
MT,2022,Reptiles & Amphibians,0,0,0,0
MT,2022,Small Mammals,2,0,0,2
NC,2011,Cats,1493,894,2651,5038
NC,2011,Dogs,1351,223,808,2382
NC,2012,Cats,1078,769,2681,4528
NC,2012,Dogs,1301,78,622,2001
NC,2013,Cats,2167,841,1844,4852
NC,2013,Dogs,1115,172,253,1540
NC,2014,Cats,1802,1213,4170,7185
NC,2014,Dogs,1306,84,1182,2572
NC,2015,Cats,932,984,4007,5923
NC,2015,Dogs,933,29,705,1667
NC,2016,Cats,4388,2587,3639,10614
NC,2016,Dogs,3218,258,871,4347
NC,2017,Cats,7762,3459,2489,13710
NC,2017,Dogs,4279,239,535,5053
NC,2018,Cats,6796,3806,4748,15350
NC,2018,Dogs,5362,328,1129,6819
NC,2019,Birds,0,0,0,0
NC,2019,Cats,5906,2809,5661,14376
NC,2019,Dogs,4390,229,1700,6319
NC,2019,Equine,0,0,0,0
NC,2019,Farm Animals,0,0,0,0
NC,2019,Rabbits,0,0,0,0
NC,2019,Reptiles & Amphibians,0,0,0,0
NC,2019,Small Mammals,0,0,0,0
NC,2020,Birds,0,0,0,0
NC,2020,Cats,3925,1770,2866,8561
NC,2020,Dogs,3035,148,1008,4191
NC,2020,Equine,0,0,0,0
NC,2020,Farm Animals,0,0,0,0
NC,2020,Rabbits,0,0,0,0
NC,2020,Reptiles & Amphibians,0,0,0,0
NC,2020,Small Mammals,0,0,0,0
NC,2021,Birds,0,0,6,6
NC,2021,Cats,3499,2583,2971,9053
NC,2021,Dogs,3115,169,893,4177
NC,2021,Equine,0,0,0,0
NC,2021,Farm Animals,2,0,3,5
NC,2021,Rabbits,0,0,1,1
NC,2021,Reptiles & Amphibians,0,0,0,0
NC,2021,Small Mammals,1,0,1,2
NC,2022,Birds,0,0,0,0
NC,2022,Cats,297,37,314,648
NC,2022,Dogs,371,20,119,510
NC,2022,Equine,2,0,0,2
NC,2022,Farm Animals,0,0,2,2
NC,2022,Rabbits,1,0,0,1
NC,2022,Reptiles & Amphibians,0,0,0,0
NC,2022,Small Mammals,1,0,1,2
ND,2013,Cats,7,1,0,8
ND,2013,Dogs,0,0,0,0
ND,2014,Cats,6,0,0,6
ND,2014,Dogs,8,0,0,8
ND,2015,Cats,6,0,0,6
ND,2015,Dogs,18,0,0,18
ND,2016,Cats,23,18,0,41
ND,2016,Dogs,16,0,0,16
ND,2017,Cats,32,9,0,41
ND,2017,Dogs,19,5,1,25
ND,2018,Cats,43,18,58,119
ND,2018,Dogs,22,2,3,27
ND,2019,Cats,28,14,95,137
ND,2019,Dogs,16,4,10,30
ND,2020,Birds,0,0,0,0
ND,2020,Cats,21,14,30,65
ND,2020,Dogs,23,6,0,29
ND,2020,Equine,0,0,0,0
ND,2020,Farm Animals,0,0,0,0
ND,2020,Rabbits,0,0,0,0
ND,2020,Reptiles & Amphibians,0,0,0,0
ND,2020,Small Mammals,1,0,0,1
ND,2021,Birds,0,0,0,0
ND,2021,Cats,28,20,5,53
ND,2021,Dogs,14,9,0,23
ND,2021,Equine,0,0,0,0
ND,2021,Farm Animals,0,0,0,0
ND,2021,Rabbits,0,0,0,0
ND,2021,Reptiles & Amphibians,0,0,0,0
ND,2021,Small Mammals,0,0,0,0
ND,2022,Birds,0,0,0,0
ND,2022,Cats,5,1,3,9
ND,2022,Dogs,0,0,0,0
ND,2022,Equine,0,0,0,0
ND,2022,Farm Animals,0,0,0,0
ND,2022,Rabbits,0,0,0,0
ND,2022,Reptiles & Amphibians,0,0,0,0
ND,2022,Small Mammals,0,0,0,0
NE,2011,Cats,17,30,71,118
NE,2011,Dogs,22,5,15,42
NE,2012,Cats,44,28,101,173
NE,2012,Dogs,36,1,9,46
NE,2013,Cats,145,151,147,443
NE,2013,Dogs,73,4,20,97
NE,2014,Cats,75,64,275,414
NE,2014,Dogs,54,1,20,75
NE,2015,Cats,105,134,419,658
NE,2015,Dogs,91,5,19,115
NE,2016,Cats,262,110,309,681
NE,2016,Dogs,70,4,16,90
NE,2017,Cats,245,143,303,691
NE,2017,Dogs,102,12,17,131
NE,2018,Cats,180,151,270,601
NE,2018,Dogs,39,23,13,75
NE,2019,Birds,0,0,0,0
NE,2019,Cats,1020,624,213,1857
NE,2019,Dogs,314,5,7,326
NE,2019,Equine,0,0,0,0
NE,2019,Farm Animals,0,0,0,0
NE,2019,Rabbits,13,0,0,13
NE,2019,Reptiles & Amphibians,1,0,0,1
NE,2019,Small Mammals,21,27,18,66
NE,2020,Birds,0,0,0,0
NE,2020,Cats,1822,554,172,2548
NE,2020,Dogs,786,27,7,820
NE,2020,Farm Animals,1,0,0,1
NE,2020,Rabbits,5,0,0,5
NE,2020,Reptiles & Amphibians,0,0,0,0
NE,2020,Small Mammals,16,3,0,19
NE,2021,Birds,2,0,0,2
NE,2021,Cats,1391,435,486,2312
NE,2021,Dogs,674,18,35,727
NE,2021,Farm Animals,4,0,1,5
NE,2021,Rabbits,5,2,1,8
NE,2021,Reptiles & Amphibians,0,0,0,0
NE,2021,Small Mammals,31,67,11,109
NE,2022,Birds,0,0,0,0
NE,2022,Cats,243,15,36,294
NE,2022,Dogs,153,8,10,171
NE,2022,Farm Animals,0,0,0,0
NE,2022,Rabbits,3,0,0,3
NE,2022,Small Mammals,4,7,0,11
NH,2011,Cats,38,4,13,55
NH,2011,Dogs,17,0,0,17
NH,2013,Cats,0,0,0,0
NH,2013,Dogs,0,0,0,0
NH,2014,Cats,55,4,15,74
NH,2014,Dogs,34,0,4,38
NH,2015,Cats,103,20,23,146
NH,2015,Dogs,56,1,7,64
NH,2016,Cats,271,50,59,380
NH,2016,Dogs,204,15,17,236
NH,2017,Cats,242,45,50,337
NH,2017,Dogs,199,16,12,227
NH,2018,Cats,256,37,38,331
NH,2018,Dogs,188,11,3,202
NH,2019,Cats,210,29,10,249
NH,2019,Dogs,167,8,0,175
NH,2020,Cats,118,17,6,141
NH,2020,Dogs,113,3,1,117
NH,2021,Birds,0,0,0,0
NH,2021,Cats,131,30,2,163
NH,2021,Dogs,114,4,3,121
NH,2021,Equine,2,0,0,2
NH,2021,Farm Animals,1,0,0,1
NH,2021,Rabbits,2,0,0,2
NH,2021,Reptiles & Amphibians,0,0,0,0
NH,2021,Small Mammals,1,0,0,1
NH,2022,Birds,0,0,0,0
NH,2022,Cats,12,0,0,12
NH,2022,Dogs,18,2,0,20
NH,2022,Equine,1,0,0,1
NH,2022,Farm Animals,0,0,0,0
NH,2022,Rabbits,0,0,0,0
NH,2022,Reptiles & Amphibians,0,0,0,0
NH,2022,Small Mammals,0,0,0,0
NJ,2012,Cats,0,0,0,0
NJ,2012,Dogs,0,0,0,0
NJ,2013,Cats,286,135,26,447
NJ,2013,Dogs,178,1,3,182
NJ,2014,Cats,94,36,6,136
NJ,2014,Dogs,93,5,3,101
NJ,2015,Cats,60,25,3,88
NJ,2015,Dogs,44,0,1,45
NJ,2016,Cats,932,585,528,2045
NJ,2016,Dogs,347,3,110,460
NJ,2017,Cats,2131,955,201,3287
NJ,2017,Dogs,493,15,57,565
NJ,2018,Cats,2124,855,397,3376
NJ,2018,Dogs,540,14,44,598
NJ,2019,Cats,1446,643,424,2513
NJ,2019,Dogs,437,6,54,497
NJ,2020,Cats,528,224,553,1305
NJ,2020,Dogs,236,5,28,269
NJ,2021,Birds,0,0,142,142
NJ,2021,Cats,613,205,223,1041
NJ,2021,Dogs,192,7,47,246
NJ,2021,Equine,0,0,0,0
NJ,2021,Farm Animals,0,0,2,2
NJ,2021,Rabbits,0,1,3,4
NJ,2021,Reptiles & Amphibians,0,0,23,23
NJ,2021,Small Mammals,7,0,2,9
NJ,2022,Birds,0,0,9,9
NJ,2022,Cats,140,13,15,168
NJ,2022,Dogs,38,3,8,49
NJ,2022,Equine,0,0,0,0
NJ,2022,Farm Animals,0,0,1,1
NJ,2022,Rabbits,0,0,0,0
NJ,2022,Reptiles & Amphibians,0,0,0,0
NJ,2022,Small Mammals,0,0,0,0
NM,2013,Cats,238,206,0,444
NM,2013,Dogs,140,253,3,396
NM,2014,Cats,258,99,40,397
NM,2014,Dogs,331,139,44,514
NM,2015,Cats,216,145,225,586
NM,2015,Dogs,408,167,283,858
NM,2016,Cats,500,587,1586,2673
NM,2016,Dogs,1017,305,1709,3031
NM,2017,Cats,1453,1126,1177,3756
NM,2017,Dogs,1472,300,1277,3049
NM,2018,Cats,1071,565,517,2153
NM,2018,Dogs,2375,447,595,3417
NM,2019,Cats,2206,1908,773,4887
NM,2019,Dogs,2910,614,354,3878
NM,2020,Cats,1311,914,360,2585
NM,2020,Dogs,1295,331,232,1858
NM,2020,Farm Animals,0,0,0,0
NM,2020,Rabbits,0,0,0,0
NM,2021,Birds,0,0,2,2
NM,2021,Cats,887,632,587,2106
NM,2021,Dogs,1578,511,313,2402
NM,2021,Equine,0,0,0,0
NM,2021,Farm Animals,1,0,0,1
NM,2021,Rabbits,2,0,0,2
NM,2021,Reptiles & Amphibians,0,0,0,0
NM,2021,Small Mammals,2,0,2,4
NM,2022,Birds,0,0,0,0
NM,2022,Cats,78,33,78,189
NM,2022,Dogs,328,84,29,441
NM,2022,Equine,0,0,0,0
NM,2022,Farm Animals,0,0,0,0
NM,2022,Rabbits,0,0,0,0
NM,2022,Reptiles & Amphibians,0,0,0,0
NM,2022,Small Mammals,4,0,0,4
NV,2011,Cats,7265,4619,4609,16493
NV,2011,Dogs,8795,641,493,9929
NV,2012,Cats,6232,3192,4717,14141
NV,2012,Dogs,7484,384,788,8656
NV,2013,Cats,4625,2361,3733,10719
NV,2013,Dogs,5975,346,677,6998
NV,2014,Cats,5894,1884,661,8439
NV,2014,Dogs,4238,228,258,4724
NV,2015,Cats,4270,1480,618,6368
NV,2015,Dogs,2764,112,175,3051
NV,2016,Cats,1791,1145,287,3223
NV,2016,Dogs,3107,185,142,3434
NV,2017,Cats,1296,661,654,2611
NV,2017,Dogs,2399,119,313,2831
NV,2018,Cats,949,419,736,2104
NV,2018,Dogs,1900,59,361,2320
NV,2019,Cats,819,498,552,1869
NV,2019,Dogs,1961,57,208,2226
NV,2020,Cats,567,235,445,1247
NV,2020,Dogs,1164,38,158,1360
NV,2021,Birds,302,5,537,844
NV,2021,Cats,478,332,423,1233
NV,2021,Dogs,1223,23,188,1434
NV,2021,Equine,1,0,1,2
NV,2021,Farm Animals,1,0,1,2
NV,2021,Rabbits,12,2,45,59
NV,2021,Reptiles & Amphibians,1,0,8,9
NV,2021,Small Mammals,8,0,50,58
NV,2022,Birds,0,0,33,33
NV,2022,Cats,82,23,64,169
NV,2022,Dogs,245,8,35,288
NV,2022,Equine,0,0,0,0
NV,2022,Farm Animals,0,0,0,0
NV,2022,Rabbits,3,4,9,16
NV,2022,Reptiles & Amphibians,0,0,0,0
NV,2022,Small Mammals,0,0,9,9
NY,2011,Cats,252,166,1488,1906
NY,2011,Dogs,214,4,211,429
NY,2012,Cats,94,65,60,219
NY,2012,Dogs,65,3,43,111
NY,2013,Cats,69,49,34,152
NY,2013,Dogs,40,3,6,49
NY,2014,Cats,143,57,68,268
NY,2014,Dogs,70,0,26,96
NY,2015,Cats,194,84,54,332
NY,2015,Dogs,123,1,31,155
NY,2015,Equine,0,0,0,0
NY,2015,Farm Animals,0,0,0,0
NY,2016,Cats,982,272,365,1619
NY,2016,Dogs,462,18,79,559
NY,2016,Rabbits,0,0,0,0
NY,2016,Small Mammals,0,0,0,0
NY,2017,Cats,876,316,414,1606
NY,2017,Dogs,763,34,205,1002
NY,2017,Small Mammals,0,0,0,0
NY,2018,Cats,789,401,226,1416
NY,2018,Dogs,619,23,112,754
NY,2018,Farm Animals,0,0,0,0
NY,2018,Rabbits,0,0,0,0
NY,2018,Small Mammals,0,0,0,0
NY,2019,Cats,879,375,270,1524
NY,2019,Dogs,625,25,148,798
NY,2019,Farm Animals,0,0,0,0
NY,2019,Rabbits,0,0,0,0
NY,2019,Reptiles & Amphibians,0,0,0,0
NY,2019,Small Mammals,0,0,11,11
NY,2020,Birds,0,0,0,0
NY,2020,Cats,725,214,218,1157
NY,2020,Dogs,505,28,107,640
NY,2020,Equine,0,0,0,0
NY,2020,Farm Animals,2,0,0,2
NY,2020,Rabbits,0,0,0,0
NY,2020,Reptiles & Amphibians,0,0,0,0
NY,2020,Small Mammals,0,0,5,5
NY,2021,Birds,1,0,0,1
NY,2021,Cats,587,219,109,915
NY,2021,Dogs,401,58,106,565
NY,2021,Equine,0,0,0,0
NY,2021,Farm Animals,0,0,2,2
NY,2021,Rabbits,3,0,3,6
NY,2021,Reptiles & Amphibians,0,0,0,0
NY,2021,Small Mammals,0,1,6,7
NY,2022,Birds,0,0,0,0
NY,2022,Cats,87,10,9,106
NY,2022,Dogs,78,4,24,106
NY,2022,Equine,0,0,0,0
NY,2022,Farm Animals,0,0,0,0
NY,2022,Rabbits,1,0,0,1
NY,2022,Reptiles & Amphibians,0,0,0,0
NY,2022,Small Mammals,0,0,0,0
OH,2011,Cats,1,0,0,1
OH,2011,Dogs,0,0,0,0
OH,2013,Cats,12,3,48,63
OH,2013,Dogs,10,0,36,46
OH,2014,Cats,258,52,688,998
OH,2014,Dogs,749,16,528,1293
OH,2015,Cats,698,272,244,1214
OH,2015,Dogs,1267,35,470,1772
OH,2016,Cats,1334,518,1148,3000
OH,2016,Dogs,2510,186,2102,4798
OH,2017,Cats,1244,560,410,2214
OH,2017,Dogs,2579,138,681,3398
OH,2018,Cats,1607,630,440,2677
OH,2018,Dogs,3250,130,567,3947
OH,2019,Cats,1795,902,347,3044
OH,2019,Dogs,2696,94,354,3144
OH,2020,Cats,884,439,298,1621
OH,2020,Dogs,1169,59,306,1534
OH,2021,Birds,0,0,0,0
OH,2021,Cats,544,315,245,1104
OH,2021,Dogs,839,31,299,1169
OH,2021,Equine,0,0,0,0
OH,2021,Farm Animals,0,0,0,0
OH,2021,Rabbits,0,0,0,0
OH,2021,Reptiles & Amphibians,0,0,0,0
OH,2021,Small Mammals,0,0,0,0
OH,2022,Birds,0,0,0,0
OH,2022,Cats,82,13,34,129
OH,2022,Dogs,222,6,49,277
OH,2022,Equine,0,0,0,0
OH,2022,Farm Animals,0,0,0,0
OH,2022,Rabbits,0,0,0,0
OH,2022,Reptiles & Amphibians,0,0,0,0
OH,2022,Small Mammals,0,0,0,0
OK,2011,Cats,0,0,0,0
OK,2011,Dogs,0,0,109,109
OK,2012,Cats,0,0,0,0
OK,2012,Dogs,0,0,126,126
OK,2013,Cats,0,0,0,0
OK,2013,Dogs,4,1,142,147
OK,2014,Cats,0,0,0,0
OK,2014,Dogs,18,1,57,76
OK,2015,Cats,6,29,0,35
OK,2015,Dogs,19,2,52,73
OK,2016,Cats,450,193,258,901
OK,2016,Dogs,459,82,204,745
OK,2017,Cats,1803,1213,154,3170
OK,2017,Dogs,4124,523,347,4994
OK,2018,Cats,1249,668,273,2190
OK,2018,Dogs,3667,533,246,4446
OK,2019,Cats,1620,1740,542,3902
OK,2019,Dogs,5468,1287,387,7142
OK,2020,Birds,0,0,0,0
OK,2020,Cats,624,457,164,1245
OK,2020,Dogs,2114,304,108,2526
OK,2020,Equine,0,0,0,0
OK,2020,Farm Animals,0,0,0,0
OK,2020,Rabbits,0,0,0,0
OK,2020,Reptiles & Amphibians,0,0,0,0
OK,2020,Small Mammals,0,0,0,0
OK,2021,Birds,0,0,0,0
OK,2021,Cats,550,1037,91,1678
OK,2021,Dogs,2416,953,43,3412
OK,2021,Equine,0,0,0,0
OK,2021,Farm Animals,0,0,0,0
OK,2021,Rabbits,1,0,0,1
OK,2021,Reptiles & Amphibians,0,0,0,0
OK,2021,Small Mammals,0,0,0,0
OK,2022,Birds,0,0,0,0
OK,2022,Cats,86,5,0,91
OK,2022,Dogs,319,45,1,365
OK,2022,Equine,0,0,0,0
OK,2022,Farm Animals,0,0,0,0
OK,2022,Rabbits,0,0,0,0
OK,2022,Reptiles & Amphibians,0,0,0,0
OK,2022,Small Mammals,0,0,0,0
OR,2011,Cats,82,10,176,268
OR,2011,Dogs,59,0,19,78
OR,2012,Cats,53,25,83,161
OR,2012,Dogs,39,0,13,52
OR,2013,Cats,74,11,59,144
OR,2013,Dogs,31,1,8,40
OR,2014,Cats,99,36,0,135
OR,2014,Dogs,30,2,0,32
OR,2015,Cats,210,38,1,249
OR,2015,Dogs,100,3,150,253
OR,2016,Cats,1049,654,551,2254
OR,2016,Dogs,699,20,364,1083
OR,2017,Cats,1075,733,548,2356
OR,2017,Dogs,775,10,315,1100
OR,2018,Cats,866,424,253,1543
OR,2018,Dogs,747,21,150,918
OR,2019,Cats,711,255,148,1114
OR,2019,Dogs,722,37,170,929
OR,2019,Small Mammals,0,0,0,0
OR,2020,Cats,645,246,126,1017
OR,2020,Dogs,473,15,105,593
OR,2021,Birds,0,0,0,0
OR,2021,Cats,433,189,68,690
OR,2021,Dogs,378,34,37,449
OR,2021,Equine,1,0,0,1
OR,2021,Farm Animals,0,0,0,0
OR,2021,Rabbits,1,1,2,4
OR,2021,Reptiles & Amphibians,0,0,0,0
OR,2021,Small Mammals,2,0,1,3
OR,2022,Birds,0,0,0,0
OR,2022,Cats,62,19,26,107
OR,2022,Dogs,80,7,6,93
OR,2022,Equine,0,0,0,0
OR,2022,Farm Animals,0,0,0,0
OR,2022,Rabbits,0,0,0,0
OR,2022,Reptiles & Amphibians,0,0,0,0
OR,2022,Small Mammals,2,0,1,3
PA,2001,Cats,0,0,0,0
PA,2001,Dogs,0,0,0,0
PA,2011,Cats,0,0,0,0
PA,2011,Dogs,0,0,0,0
PA,2012,Cats,0,0,0,0
PA,2012,Dogs,0,0,0,0
PA,2013,Cats,3481,2382,28,5891
PA,2013,Dogs,2477,122,4,2603
PA,2014,Cats,2600,1353,88,4041
PA,2014,Dogs,2061,47,12,2120
PA,2015,Cats,2531,904,1811,5246
PA,2015,Dogs,1968,65,342,2375
PA,2016,Cats,2688,727,3051,6466
PA,2016,Dogs,1564,53,1004,2621
PA,2017,Cats,2310,968,1351,4629
PA,2017,Dogs,1423,38,393,1854
PA,2018,Cats,2187,1530,907,4624
PA,2018,Dogs,1329,42,125,1496
PA,2019,Birds,0,0,0,0
PA,2019,Cats,2130,1153,1086,4369
PA,2019,Dogs,1122,33,204,1359
PA,2019,Farm Animals,0,0,0,0
PA,2019,Rabbits,0,0,1,1
PA,2019,Reptiles & Amphibians,0,0,0,0
PA,2019,Small Mammals,0,0,1,1
PA,2020,Birds,2,0,0,2
PA,2020,Cats,1372,590,855,2817
PA,2020,Dogs,831,31,132,994
PA,2020,Equine,0,0,0,0
PA,2020,Farm Animals,0,0,0,0
PA,2020,Rabbits,4,4,0,8
PA,2020,Reptiles & Amphibians,1,0,0,1
PA,2020,Small Mammals,2,2,1,5
PA,2021,Birds,1,2,0,3
PA,2021,Cats,1131,533,525,2189
PA,2021,Dogs,791,45,66,902
PA,2021,Equine,0,0,0,0
PA,2021,Farm Animals,0,0,0,0
PA,2021,Rabbits,10,0,1,11
PA,2021,Reptiles & Amphibians,1,1,0,2
PA,2021,Small Mammals,4,2,5,11
PA,2022,Birds,0,0,0,0
PA,2022,Cats,138,14,45,197
PA,2022,Dogs,87,4,7,98
PA,2022,Equine,0,0,0,0
PA,2022,Farm Animals,0,0,0,0
PA,2022,Rabbits,0,0,0,0
PA,2022,Reptiles & Amphibians,1,0,0,1
PA,2022,Small Mammals,0,0,0,0
PR,2018,Cats,2,0,0,2
PR,2018,Dogs,9,0,0,9
PR,2019,Cats,481,447,671,1599
PR,2019,Dogs,1284,325,485,2094
PR,2020,Cats,307,270,0,577
PR,2020,Dogs,611,252,0,863
PR,2021,Birds,0,0,0,0
PR,2021,Cats,330,436,0,766
PR,2021,Dogs,237,76,0,313
PR,2021,Equine,0,0,0,0
PR,2021,Farm Animals,0,0,0,0
PR,2021,Rabbits,0,0,0,0
PR,2021,Reptiles & Amphibians,0,0,0,0
PR,2021,Small Mammals,0,0,0,0
PR,2022,Birds,0,0,0,0
PR,2022,Cats,40,23,0,63
PR,2022,Dogs,11,0,0,11
PR,2022,Equine,0,0,0,0
PR,2022,Farm Animals,0,0,0,0
PR,2022,Rabbits,0,0,0,0
PR,2022,Reptiles & Amphibians,0,0,0,0
PR,2022,Small Mammals,0,0,0,0
RI,2013,Cats,195,67,0,262
RI,2013,Dogs,146,1,0,147
RI,2014,Cats,134,16,8,158
RI,2014,Dogs,114,1,4,119
RI,2015,Cats,69,41,15,125
RI,2015,Dogs,96,1,10,107
RI,2016,Cats,94,15,6,115
RI,2016,Dogs,84,0,4,88
RI,2017,Cats,36,3,1,40
RI,2017,Dogs,48,0,3,51
RI,2018,Cats,42,6,2,50
RI,2018,Dogs,67,0,1,68
RI,2019,Cats,76,15,4,95
RI,2019,Dogs,61,3,0,64
RI,2020,Cats,39,28,2,69
RI,2020,Dogs,44,2,0,46
RI,2021,Birds,1,0,0,1
RI,2021,Cats,36,6,0,42
RI,2021,Dogs,44,1,0,45
RI,2021,Equine,0,0,0,0
RI,2021,Farm Animals,0,0,0,0
RI,2021,Rabbits,1,0,0,1
RI,2021,Reptiles & Amphibians,0,0,0,0
RI,2021,Small Mammals,1,0,0,1
RI,2022,Birds,0,0,0,0
RI,2022,Cats,1,0,0,1
RI,2022,Dogs,5,0,0,5
RI,2022,Equine,0,0,0,0
RI,2022,Farm Animals,0,0,0,0
RI,2022,Rabbits,0,0,0,0
RI,2022,Reptiles & Amphibians,0,0,0,0
RI,2022,Small Mammals,0,0,0,0
SC,2011,Cats,570,763,360,1693
SC,2011,Dogs,568,586,61,1215
SC,2012,Cats,553,986,208,1747
SC,2012,Dogs,553,615,118,1286
SC,2013,Cats,328,877,2143,3348
SC,2013,Dogs,435,454,1316,2205
SC,2014,Cats,245,633,2150,3028
SC,2014,Dogs,343,367,1077,1787
SC,2015,Cats,1597,1117,1544,4258
SC,2015,Dogs,1309,297,765,2371
SC,2016,Cats,3109,2176,1494,6779
SC,2016,Dogs,2440,441,600,3481
SC,2017,Cats,950,1636,2465,5051
SC,2017,Dogs,1356,257,591,2204
SC,2018,Cats,1549,1549,2530,5628
SC,2018,Dogs,1639,233,619,2491
SC,2019,Cats,1366,1468,3273,6107
SC,2019,Dogs,1714,107,460,2281
SC,2020,Birds,0,0,0,0
SC,2020,Cats,945,847,1620,3412
SC,2020,Dogs,907,51,193,1151
SC,2020,Equine,0,0,0,0
SC,2020,Rabbits,0,0,1,1
SC,2021,Birds,1,0,0,1
SC,2021,Cats,805,394,1634,2833
SC,2021,Dogs,979,79,209,1267
SC,2021,Equine,0,0,0,0
SC,2021,Farm Animals,0,0,0,0
SC,2021,Rabbits,0,0,0,0
SC,2021,Reptiles & Amphibians,0,0,0,0
SC,2021,Small Mammals,0,0,0,0
SC,2022,Birds,0,0,4,4
SC,2022,Cats,208,14,177,399
SC,2022,Dogs,237,17,67,321
SC,2022,Equine,0,0,0,0
SC,2022,Farm Animals,0,0,1,1
SC,2022,Rabbits,0,0,0,0
SC,2022,Reptiles & Amphibians,0,0,0,0
SC,2022,Small Mammals,0,0,0,0
SD,2014,Cats,0,0,0,0
SD,2014,Dogs,0,0,0,0
SD,2015,Cats,0,2,0,2
SD,2015,Dogs,0,0,0,0
SD,2016,Cats,10,7,0,17
SD,2016,Dogs,3,0,0,3
SD,2017,Cats,11,0,0,11
SD,2017,Dogs,1,0,0,1
SD,2018,Cats,2,2,0,4
SD,2018,Dogs,3,0,0,3
SD,2019,Cats,4,45,1,50
SD,2019,Dogs,4,0,1,5
SD,2020,Cats,7,5,3,15
SD,2020,Dogs,6,0,0,6
SD,2021,Cats,16,7,2,25
SD,2021,Dogs,8,0,0,8
SD,2021,Farm Animals,0,0,0,0
SD,2021,Rabbits,0,0,0,0
SD,2022,Cats,11,0,0,11
SD,2022,Dogs,3,0,0,3
TN,2011,Cats,0,0,0,0
TN,2011,Dogs,0,0,0,0
TN,2012,Birds,0,0,0,0
TN,2012,Cats,203,217,432,852
TN,2012,Dogs,198,82,317,597
TN,2012,Farm Animals,0,0,0,0
TN,2012,Reptiles & Amphibians,0,0,0,0
TN,2012,Small Mammals,0,0,0,0
TN,2013,Birds,0,0,0,0
TN,2013,Cats,759,1135,528,2422
TN,2013,Dogs,1264,297,279,1840
TN,2013,Farm Animals,0,0,0,0
TN,2013,Rabbits,0,0,0,0
TN,2013,Reptiles & Amphibians,0,0,0,0
TN,2013,Small Mammals,0,0,0,0
TN,2014,Birds,0,0,0,0
TN,2014,Cats,430,513,142,1085
TN,2014,Dogs,888,173,85,1146
TN,2014,Farm Animals,0,0,0,0
TN,2014,Rabbits,0,0,0,0
TN,2014,Reptiles & Amphibians,0,0,1,1
TN,2014,Small Mammals,0,0,0,0
TN,2015,Birds,0,0,0,0
TN,2015,Cats,745,1066,50,1861
TN,2015,Dogs,441,108,112,661
TN,2015,Farm Animals,0,0,1,1
TN,2015,Rabbits,0,0,0,0
TN,2015,Reptiles & Amphibians,0,0,0,0
TN,2015,Small Mammals,0,0,0,0
TN,2016,Birds,0,0,0,0
TN,2016,Cats,3290,3204,337,6831
TN,2016,Dogs,2740,293,177,3210
TN,2016,Farm Animals,0,0,1,1
TN,2016,Rabbits,0,0,0,0
TN,2016,Reptiles & Amphibians,0,0,0,0
TN,2016,Small Mammals,0,0,0,0
TN,2017,Birds,0,0,0,0
TN,2017,Cats,3008,3474,70,6552
TN,2017,Dogs,3614,419,45,4078
TN,2017,Small Mammals,0,0,0,0
TN,2018,Birds,0,0,0,0
TN,2018,Cats,2094,2528,169,4791
TN,2018,Dogs,3246,224,133,3603
TN,2018,Farm Animals,0,0,0,0
TN,2018,Rabbits,0,0,0,0
TN,2018,Small Mammals,0,0,0,0
TN,2019,Birds,0,0,0,0
TN,2019,Cats,1974,2696,474,5144
TN,2019,Dogs,3367,198,270,3835
TN,2019,Farm Animals,0,0,0,0
TN,2019,Rabbits,0,0,0,0
TN,2019,Reptiles & Amphibians,0,0,0,0
TN,2019,Small Mammals,0,0,0,0
TN,2020,Birds,0,0,1,1
TN,2020,Cats,1285,1443,210,2938
TN,2020,Dogs,1953,71,165,2189
TN,2020,Farm Animals,0,0,0,0
TN,2020,Rabbits,0,0,0,0
TN,2020,Reptiles & Amphibians,0,0,0,0
TN,2021,Birds,2,0,0,2
TN,2021,Cats,969,969,97,2035
TN,2021,Dogs,1784,87,95,1966
TN,2021,Equine,0,0,0,0
TN,2021,Farm Animals,0,1,1,2
TN,2021,Rabbits,2,1,1,4
TN,2021,Reptiles & Amphibians,1,0,0,1
TN,2021,Small Mammals,2,0,1,3
TN,2022,Birds,0,0,0,0
TN,2022,Cats,182,31,27,240
TN,2022,Dogs,433,44,25,502
TN,2022,Equine,0,0,0,0
TN,2022,Farm Animals,0,0,1,1
TN,2022,Rabbits,0,0,1,1
TN,2022,Reptiles & Amphibians,0,0,0,0
TN,2022,Small Mammals,0,1,0,1
TX,2011,Cats,0,0,0,0
TX,2011,Dogs,0,0,0,0
TX,2012,Cats,0,0,0,0
TX,2012,Dogs,0,0,0,0
TX,2013,Cats,354,542,1913,2809
TX,2013,Dogs,575,104,3874,4553
TX,2014,Cats,722,1204,880,2806
TX,2014,Dogs,4850,551,1598,6999
TX,2015,Birds,0,0,0,0
TX,2015,Cats,1195,2471,11117,14783
TX,2015,Dogs,6968,739,9782,17489
TX,2015,Rabbits,0,0,4,4
TX,2015,Reptiles & Amphibians,0,0,0,0
TX,2015,Small Mammals,0,0,0,0
TX,2016,Birds,0,0,0,0
TX,2016,Cats,3670,4723,13382,21775
TX,2016,Dogs,12880,1953,12588,27421
TX,2016,Rabbits,0,0,4,4
TX,2016,Small Mammals,0,0,0,0
TX,2017,Birds,0,0,2,2
TX,2017,Cats,3107,5163,18075,26345
TX,2017,Dogs,15304,4722,15188,35214
TX,2017,Rabbits,0,0,10,10
TX,2017,Reptiles & Amphibians,0,0,0,0
TX,2017,Small Mammals,0,0,3,3
TX,2018,Birds,0,0,0,0
TX,2018,Cats,4893,5009,10578,20480
TX,2018,Dogs,15174,2924,12445,30543
TX,2018,Rabbits,0,0,2,2
TX,2018,Small Mammals,0,0,4,4
TX,2019,Birds,0,0,0,0
TX,2019,Cats,6270,6895,7889,21054
TX,2019,Dogs,13993,2304,7538,23835
TX,2019,Equine,0,0,0,0
TX,2019,Farm Animals,0,0,0,0
TX,2019,Rabbits,0,0,1,1
TX,2019,Reptiles & Amphibians,0,0,0,0
TX,2019,Small Mammals,0,0,0,0
TX,2020,Birds,0,0,0,0
TX,2020,Cats,3019,2740,2027,7786
TX,2020,Dogs,5872,1031,1158,8061
TX,2020,Equine,0,0,0,0
TX,2020,Farm Animals,0,0,0,0
TX,2020,Rabbits,0,0,0,0
TX,2020,Reptiles & Amphibians,0,0,0,0
TX,2020,Small Mammals,0,0,0,0
TX,2021,Birds,19,4,0,23
TX,2021,Cats,2573,3834,2883,9290
TX,2021,Dogs,6588,1363,2186,10137
TX,2021,Equine,1,0,0,1
TX,2021,Farm Animals,2,0,0,2
TX,2021,Rabbits,14,6,2,22
TX,2021,Reptiles & Amphibians,4,0,0,4
TX,2021,Small Mammals,79,45,6,130
TX,2022,Birds,1,0,0,1
TX,2022,Cats,278,83,304,665
TX,2022,Dogs,1255,156,503,1914
TX,2022,Equine,0,0,0,0
TX,2022,Farm Animals,1,0,0,1
TX,2022,Rabbits,2,0,0,2
TX,2022,Reptiles & Amphibians,0,0,0,0
TX,2022,Small Mammals,12,3,0,15
UT,2008,Cats,23,1,9,33
UT,2008,Dogs,16,0,1,17
UT,2009,Cats,64,44,52,160
UT,2009,Dogs,48,0,8,56
UT,2010,Cats,42,5,13,60
UT,2010,Dogs,31,1,2,34
UT,2011,Cats,579,432,449,1460
UT,2011,Dogs,278,12,24,314
UT,2012,Cats,150,133,121,404
UT,2012,Dogs,91,8,5,104
UT,2013,Cats,77,66,24,167
UT,2013,Dogs,56,4,5,65
UT,2014,Cats,428,89,21,538
UT,2014,Dogs,120,6,5,131
UT,2015,Cats,368,104,28,500
UT,2015,Dogs,145,3,6,154
UT,2016,Cats,606,265,1987,2858
UT,2016,Dogs,297,13,589,899
UT,2017,Cats,629,251,1771,2651
UT,2017,Dogs,242,5,495,742
UT,2018,Cats,865,387,954,2206
UT,2018,Dogs,383,43,274,700
UT,2019,Cats,710,373,675,1758
UT,2019,Dogs,441,26,124,591
UT,2020,Birds,0,0,0,0
UT,2020,Cats,504,95,391,990
UT,2020,Dogs,319,8,90,417
UT,2020,Equine,0,0,0,0
UT,2020,Farm Animals,0,0,0,0
UT,2020,Rabbits,0,0,0,0
UT,2020,Reptiles & Amphibians,0,0,0,0
UT,2020,Small Mammals,0,0,0,0
UT,2021,Birds,1,0,0,1
UT,2021,Cats,486,166,523,1175
UT,2021,Dogs,344,28,73,445
UT,2021,Equine,0,0,0,0
UT,2021,Farm Animals,0,0,0,0
UT,2021,Rabbits,0,3,2,5
UT,2021,Reptiles & Amphibians,0,0,0,0
UT,2021,Small Mammals,7,0,0,7
UT,2022,Birds,0,0,0,0
UT,2022,Cats,86,8,140,234
UT,2022,Dogs,82,20,11,113
UT,2022,Equine,0,0,0,0
UT,2022,Farm Animals,0,0,0,0
UT,2022,Rabbits,0,0,0,0
UT,2022,Reptiles & Amphibians,0,0,0,0
UT,2022,Small Mammals,4,0,0,4
VA,2011,Cats,0,0,459,459
VA,2011,Dogs,0,0,268,268
VA,2012,Cats,0,0,360,360
VA,2012,Dogs,0,0,281,281
VA,2013,Cats,3,6,312,321
VA,2013,Dogs,5,0,209,214
VA,2014,Cats,48,67,104,219
VA,2014,Dogs,36,10,101,147
VA,2015,Cats,112,108,187,407
VA,2015,Dogs,122,9,171,302
VA,2016,Cats,963,488,1527,2978
VA,2016,Dogs,1019,35,774,1828
VA,2016,Small Mammals,0,0,0,0
VA,2017,Birds,0,0,0,0
VA,2017,Cats,1473,923,555,2951
VA,2017,Dogs,1011,48,238,1297
VA,2017,Rabbits,0,0,0,0
VA,2017,Small Mammals,2,0,2,4
VA,2018,Birds,0,0,0,0
VA,2018,Cats,2044,1345,560,3949
VA,2018,Dogs,1636,82,132,1850
VA,2018,Rabbits,1,0,0,1
VA,2018,Small Mammals,3,0,0,3
VA,2019,Birds,0,1,0,1
VA,2019,Cats,2802,1023,200,4025
VA,2019,Dogs,1842,58,72,1972
VA,2019,Equine,0,0,0,0
VA,2019,Farm Animals,0,0,0,0
VA,2019,Rabbits,1,1,0,2
VA,2019,Reptiles & Amphibians,0,0,0,0
VA,2019,Small Mammals,0,0,0,0
VA,2020,Birds,0,0,0,0
VA,2020,Cats,1196,614,240,2050
VA,2020,Dogs,961,56,92,1109
VA,2020,Equine,0,0,0,0
VA,2020,Farm Animals,0,0,0,0
VA,2020,Rabbits,1,0,0,1
VA,2020,Reptiles & Amphibians,0,0,0,0
VA,2020,Small Mammals,1,0,0,1
VA,2021,Birds,3,0,5,8
VA,2021,Cats,935,591,393,1919
VA,2021,Dogs,738,64,82,884
VA,2021,Equine,1,0,0,1
VA,2021,Farm Animals,0,0,0,0
VA,2021,Rabbits,3,0,3,6
VA,2021,Reptiles & Amphibians,0,0,0,0
VA,2021,Small Mammals,1,1,0,2
VA,2022,Birds,0,0,2,2
VA,2022,Cats,90,28,29,147
VA,2022,Dogs,126,2,19,147
VA,2022,Equine,1,0,0,1
VA,2022,Farm Animals,0,0,0,0
VA,2022,Rabbits,0,0,0,0
VA,2022,Reptiles & Amphibians,0,0,0,0
VA,2022,Small Mammals,2,0,0,2
VI,2019,Cats,53,37,27,117
VI,2019,Dogs,265,133,8,406
VI,2020,Cats,30,38,0,68
VI,2020,Dogs,171,78,0,249
VI,2021,Birds,4,1,0,5
VI,2021,Cats,29,35,0,64
VI,2021,Dogs,294,93,0,387
VI,2021,Equine,0,0,0,0
VI,2021,Farm Animals,0,0,0,0
VI,2021,Rabbits,0,0,0,0
VI,2021,Reptiles & Amphibians,0,0,0,0
VI,2021,Small Mammals,0,0,0,0
VI,2022,Cats,0,0,0,0
VT,2013,Cats,83,4,2,89
VT,2013,Dogs,38,0,0,38
VT,2014,Cats,234,88,13,335
VT,2014,Dogs,88,6,0,94
VT,2015,Cats,238,132,5,375
VT,2015,Dogs,117,6,12,135
VT,2016,Cats,254,109,7,370
VT,2016,Dogs,138,9,7,154
VT,2017,Cats,250,139,3,392
VT,2017,Dogs,132,15,5,152
VT,2018,Cats,200,156,15,371
VT,2018,Dogs,150,7,4,161
VT,2019,Cats,187,99,16,302
VT,2019,Dogs,122,3,3,128
VT,2020,Cats,168,60,7,235
VT,2020,Dogs,97,1,2,100
VT,2021,Birds,0,0,0,0
VT,2021,Cats,145,88,13,246
VT,2021,Dogs,79,1,3,83
VT,2021,Equine,0,0,0,0
VT,2021,Farm Animals,0,0,0,0
VT,2021,Rabbits,2,0,0,2
VT,2021,Reptiles & Amphibians,0,0,0,0
VT,2021,Small Mammals,1,0,0,1
VT,2022,Cats,21,2,0,23
VT,2022,Dogs,13,0,0,13
VT,2022,Rabbits,0,0,0,0
VT,2022,Small Mammals,3,0,0,3
WA,2011,Cats,0,0,420,420
WA,2011,Dogs,0,0,108,108
WA,2012,Cats,6,3,214,223
WA,2012,Dogs,1,0,49,50
WA,2012,Rabbits,0,0,0,0
WA,2013,Cats,130,106,181,417
WA,2013,Dogs,100,12,33,145
WA,2013,Rabbits,0,0,0,0
WA,2014,Birds,0,0,0,0
WA,2014,Cats,442,130,68,640
WA,2014,Dogs,228,8,49,285
WA,2014,Rabbits,0,0,1,1
WA,2015,Birds,0,0,0,0
WA,2015,Cats,767,224,516,1507
WA,2015,Dogs,290,14,57,361
WA,2015,Rabbits,0,0,0,0
WA,2015,Reptiles & Amphibians,0,0,0,0
WA,2016,Birds,0,0,0,0
WA,2016,Cats,3288,1428,596,5312
WA,2016,Dogs,1515,48,125,1688
WA,2016,Rabbits,0,0,0,0
WA,2016,Small Mammals,0,0,0,0
WA,2017,Cats,2306,1028,429,3763
WA,2017,Dogs,1298,68,99,1465
WA,2017,Rabbits,0,0,0,0
WA,2017,Small Mammals,0,0,0,0
WA,2018,Cats,2208,742,143,3093
WA,2018,Dogs,1346,55,70,1471
WA,2018,Rabbits,0,0,0,0
WA,2019,Cats,2188,986,454,3628
WA,2019,Dogs,1228,78,161,1467
WA,2019,Rabbits,0,0,0,0
WA,2020,Birds,0,0,0,0
WA,2020,Cats,1401,526,342,2269
WA,2020,Dogs,759,29,95,883
WA,2021,Birds,1,1,2,4
WA,2021,Cats,1264,535,331,2130
WA,2021,Dogs,793,54,80,927
WA,2021,Equine,0,0,1,1
WA,2021,Farm Animals,4,0,1,5
WA,2021,Rabbits,10,2,9,21
WA,2021,Reptiles & Amphibians,4,0,3,7
WA,2021,Small Mammals,1,1,4,6
WA,2022,Birds,0,0,0,0
WA,2022,Cats,245,26,36,307
WA,2022,Dogs,159,3,13,175
WA,2022,Equine,0,0,0,0
WA,2022,Farm Animals,0,0,0,0
WA,2022,Rabbits,0,0,1,1
WA,2022,Reptiles & Amphibians,0,0,0,0
WA,2022,Small Mammals,0,0,0,0
WI,2011,Cats,430,118,191,739
WI,2011,Dogs,105,11,76,192
WI,2012,Cats,238,98,210,546
WI,2012,Dogs,103,3,62,168
WI,2013,Cats,753,447,292,1492
WI,2013,Dogs,177,7,31,215
WI,2014,Cats,820,536,140,1496
WI,2014,Dogs,174,3,42,219
WI,2015,Cats,748,336,154,1238
WI,2015,Dogs,188,5,40,233
WI,2016,Cats,2392,918,290,3600
WI,2016,Dogs,1070,22,39,1131
WI,2017,Cats,2935,1416,469,4820
WI,2017,Dogs,1293,34,75,1402
WI,2018,Cats,2365,1038,556,3959
WI,2018,Dogs,1446,37,106,1589
WI,2018,Rabbits,0,0,0,0
WI,2018,Small Mammals,0,0,0,0
WI,2019,Cats,1939,754,480,3173
WI,2019,Dogs,1270,66,108,1444
WI,2020,Cats,1148,425,278,1851
WI,2020,Dogs,782,30,65,877
WI,2021,Birds,1,0,93,94
WI,2021,Cats,681,261,188,1130
WI,2021,Dogs,540,14,43,597
WI,2021,Equine,0,0,0,0
WI,2021,Farm Animals,0,0,2,2
WI,2021,Rabbits,1,0,3,4
WI,2021,Reptiles & Amphibians,3,0,7,10
WI,2021,Small Mammals,20,1,4,25
WI,2022,Birds,0,0,2,2
WI,2022,Cats,124,23,30,177
WI,2022,Dogs,139,7,20,166
WI,2022,Equine,0,0,0,0
WI,2022,Farm Animals,0,0,0,0
WI,2022,Rabbits,1,0,0,1
WI,2022,Reptiles & Amphibians,0,0,0,0
WI,2022,Small Mammals,9,0,0,9
WV,2015,Cats,8,4,0,12
WV,2015,Dogs,5,0,0,5
WV,2016,Cats,481,360,2182,3023
WV,2016,Dogs,233,59,267,559
WV,2017,Cats,330,170,1062,1562
WV,2017,Dogs,123,36,179,338
WV,2018,Cats,136,138,772,1046
WV,2018,Dogs,87,27,72,186
WV,2019,Cats,231,266,889,1386
WV,2019,Dogs,161,18,141,320
WV,2020,Cats,298,343,57,698
WV,2020,Dogs,148,23,17,188
WV,2021,Birds,0,0,0,0
WV,2021,Cats,246,344,33,623
WV,2021,Dogs,179,22,25,226
WV,2021,Equine,0,0,0,0
WV,2021,Farm Animals,0,0,0,0
WV,2021,Rabbits,5,0,0,5
WV,2021,Reptiles & Amphibians,0,0,0,0
WV,2021,Small Mammals,1,0,0,1
WV,2022,Birds,0,0,0,0
WV,2022,Cats,36,16,0,52
WV,2022,Dogs,22,2,0,24
WV,2022,Equine,0,0,0,0
WV,2022,Farm Animals,0,0,0,0
WV,2022,Rabbits,0,0,0,0
WV,2022,Reptiles & Amphibians,0,0,0,0
WV,2022,Small Mammals,1,0,0,1
WY,2012,Cats,0,0,0,0
WY,2012,Dogs,0,0,0,0
WY,2013,Cats,9,3,4,16
WY,2013,Dogs,0,0,0,0
WY,2014,Cats,138,153,126,417
WY,2014,Dogs,65,16,5,86
WY,2015,Cats,243,211,343,797
WY,2015,Dogs,130,6,17,153
WY,2016,Cats,256,207,277,740
WY,2016,Dogs,129,8,18,155
WY,2017,Cats,283,185,185,653
WY,2017,Dogs,172,4,31,207
WY,2018,Cats,201,267,108,576
WY,2018,Dogs,232,9,23,264
WY,2019,Cats,242,174,77,493
WY,2019,Dogs,143,2,23,168
WY,2019,Farm Animals,0,0,0,0
WY,2019,Rabbits,2,0,0,2
WY,2019,Small Mammals,3,0,0,3
WY,2020,Cats,144,53,28,225
WY,2020,Dogs,106,5,8,119
WY,2020,Farm Animals,0,0,0,0
WY,2020,Rabbits,0,0,0,0
WY,2020,Small Mammals,0,0,0,0
WY,2021,Birds,0,0,0,0
WY,2021,Cats,136,34,11,181
WY,2021,Dogs,104,10,6,120
WY,2021,Equine,0,0,0,0
WY,2021,Farm Animals,0,0,0,0
WY,2021,Rabbits,1,0,0,1
WY,2021,Reptiles & Amphibians,0,0,0,0
WY,2021,Small Mammals,0,0,0,0
WY,2022,Birds,0,0,0,0
WY,2022,Cats,14,0,5,19
WY,2022,Dogs,13,1,0,14
WY,2022,Equine,0,0,0,0
WY,2022,Farm Animals,0,0,0,0
WY,2022,Rabbits,0,10,1,11
WY,2022,Reptiles & Amphibians,0,0,0,0
WY,2022,Small Mammals,1,0,0,1